text	label
아이스아메리카노 하나요	테이크아웃하실 건가요?
네 텀블러에 넣어주세요	텀블러 할인 300원 해드릴게요
그란데 사이즈로 주세요	적립카드 있으세요?
네 보고쿠폰으로 결제할게요	현금영수증 해드릴까요?
괜찮습니다	저쪽에서 잠시만 대기해주세요
저 카푸치노로 주문할게요	시럽은 얼마나 뿌려드릴까요?
3번 뿌려주세요	위에 크림 올려드릴까요?
네 많이 올려주세요	오늘 이벤트 해서 커피를 주문하시면 2000원 추가하시면 브레드를 드립니다
그럼 2000원 추가해서 브레드도 같이 시킬게요	그럼 카푸치노와 브레드 결제 도와드리겠습니다
저 도장 다 모았는데 나중에 써도 되나요?	네 다음에 써도 됩니다
이 기프티콘 여기서 사용할 수 있나요?	사용 가능하십니다
그럼 이 기프티콘 쓰고 다른걸로 주문할게요	어떤 걸로 하시겠어요?
자바칩 프라푸치노에 휘핑 빼고요	6600원입니다
여기 기프티콘 대면 되죠?	네 현금영수증 해드릴까요?
네 번호 입력할게요	다 되셨습니다
따뜻한 아메리카노 한 잔, 아이스라떼 한 잔이요.	드시고 가시나요?
네, 그런데 중간에 테이크 아웃도 가능한가요?	네, 카운터로 오시면 테이크 아웃 잔에 담아드려요.
네, 스콘도 3개 같이 주세요.	스콘도 드시고 가시나요?
네.	데워드릴까요?
네, 데워주세요.	네, 잠시만 기다려주세요.
카푸치노 차갑게 되나요?	가능합니다
아이스 카푸치노 개인컵에 주실 수 있나요?	개인컵 사이즈가 작아서 음료가 다 안 들어가요
음료와 같이 먹을 빵 추천해주세요	호두 베이글이 잘 어울려요
모바일 쿠폰으로 결제할 수 있어요?	네 가능해요
화장실은 어디에 있나요?	오른쪽 벽쪽으로 있어요
여기에서 제일 잘나가는 커피가 뭐에요?	요새는 이 라이트한 맛의 아이스아메리카노가 제일 잘나가요.
라이트한 맛의 아이스아메리카노요?	네, 저희 가게 마스코트 메뉴에요.
그럼 그거 한잔하고, 카페라떼 주세요.	처음오시는거면, 쿠폰 찍어 드릴까요?
쿠폰 찍어주세요!	10개 다모아오시면 커피한잔 드려요.
오, 감사합니다!	편하신 자리 앉아계시면 가져다 드릴게요.
아메리카노 톨 사이즈로 주세요	따뜻한 거로 드릴까요?
네 그리고 이 맴버쉽 할인 사용할게요	네 드시고 가시나요?
네 먹고갈게요	3600원 결제 도와드리겠습니다
진동밸을 따로 주시나요?	주문번호로 불러드리겠습니다
와이파이 비밀번호는 뭐에요?	영수증 하단에 적혀있습니다
계절메뉴 주문가능한가요?	네, 가능합니다.
배달 하시나요?	네, 배달비 3000원입니다.
콘센트 자리 있나요?	네, 있습니다.
커피에 샷 추가 가능한가요?	네, 가능합니다. 
남은 음료 담아 주시나요?	네, 담아드립니다.
밀크티 있나요?	네 있습니다
밀크티에 혹시 우유가 들어가나요 아니면 우유 분말이 들어가나요?	저희는 우유 분말을 사용하고 있어요
밀크티 홍차 종류는 뭐가 있어요?	루이보스, 아쌈 이렇게 두개있습니다.
그럼 루이보스 밀크티 하나 주시겠어요?	네 알겠습니다.
쿠폰 주시나요?	네 드릴게요 잠시만요
아이스 아메리카노 한잔이요	드시고 가시는거세요?
아니요	테이크 아웃은 잔 값 따로 더 받는데 괜찮으시겠어요?
텀블러 가져왔는데 여기에 담아주세요	알겠습니다
쿠폰 있는데 도장도 찍어주세요	도장 이미 다 채우셔서 이번 음료 무료로 가능하신데 결제 취소하고 무료로 드릴까요?
다음번에 무료로 하고 이번엔 새로 도장 찍어주세요	네
2명 창가자리에 앉을 수 있을까요?	네 기다리시면 안내해드릴게요
네 부탁드립니다	주문은 어떤걸로 하시겠어요?
저는 우선 따뜻한 물이랑 커피주세요	커피는 시럽은 넣어드릴까요?
아니요 시럽넣지 말고 주세요	네 더 필요한건 없으세요?
혹시 빵 종류도 있나요?	네 저기서 직접 가져오시면 됩니다
아메리카노 한 잔에 얼마죠?	2500원입니다.
사이즈업 되나요?	네 가능합니다.
두 잔 테이크아웃 할게요.	네.
이 쿠폰 쓸 수 있죠?	네.
얼마나 걸리나요?	바로 만들어드릴게요.
카푸치노 한잔이랑 아메리카노 두잔 주세요.	네, 뜨거운 음료로 드릴까요?
카푸치노는 빅사이즈로 주시고 아메리카노는 스몰로 주시겠어요?	네, 다른거 더 필요한거 없으세요?
얼마나 걸릴까요?	대략 5분정도 걸립니다.
음료랑 다 해서 얼마에요?	14,500원입니다.
죄송한데 조각 케이크도 추가해주시겠어요?	네, 어떤 거로 드릴까요?
아메리카노 한잔 주세요.	드시고 가시나요?
네, 텀블러에 담아주실 수 있나요? 	네 그럼요.
텀블러 할인 있나요?	네 500원 할인되세요.
치즈케익도 하나 주세요.	네 결제 도와드릴게요.
삼성페이 되나요?	네 가능하세요.
아메리카노 한잔 주문 할 수 있을까요?	네, 주문 가능합니다.
아메리카노는 어떤 종류가 있나요?	디카페인과 기본 아메리카노 2종류 있습니다.
디카페인으로 한잔 주문할게요.	결제는 어떻게 도와드릴까요?
카카오 페이로 결제 가능한가요?	네, 가능합니다.
포인트 적립 같이 할 수 있나요?	네, 같이 적립해 드리겠습니다.
커피 주문할게요	네 어떤걸로 하시겠습니까
네 오늘의 커피로 주세요	네 사이즈는 어떤걸로 주문넣어 드릴까요
아 네 제일 양이 적은 숏으로 할게요	아 네 알겠습니다. 
근데 오늘의 커피는 무슨커피로 하나요 매번 맛이 다르던데	아 네 오늘은 과테말라 커피입니다
아네 제가 젤 좋아하는 커피인데요	오늘 딱 맞게 오셨네요
페퍼민트 티 하나주세요.	따뜻한 것으로 드릴가요?
사이즈업 되나요?	아니요, 한 사이즈로만 판매하고 있습니다.
머핀은 뭐가 제일 맛있나요?	블루베리 머핀이 잘 나갑니다.
그럼 블루베리 머핀도 같이 주세요.	네, 더 필요한 거 없으신가요?
현금 영수증 해주세요.	네, 번호 찍어주세요.
주문하려고 해요.	네 손님. 메뉴는 어떻게 드릴까요?
아이스 아메리카노랑 따뜻한 라떼로 주세요.	사이즈는 어떻게 드릴까요?
둘 다 톨 사이즈로 주세요.	여기서 드시고 가나요, 가져가시나요?
여기서 먹고 가겠습니다.	요즘 환경정책때문에 머그잔으로 드리도록 하겠습니다.
아 그리고 라떼는 우유 좀 적게 주세요.	네, 모두 다 해서 8,000원 나왔습니다.
아아 주문 가능한가요?	네 당연히 가능합니다. 
언제 음료가 나오나요?	10분 내로 나갑니다. 
혹시 아이리쉬 커피도 판매하나요?	아니요 아이리쉬 커피는 판매하지 않습니다. 
캐리어에 넣어 주실 수 있나요?	아뇨 캐리어는 2개 이상부터 가능해요.
실내에서 일회용 사용 가능한가요?	아뇨 현재 법적으로 금지하고 있어요.
한사람당 한잔씩 시켜야 하나요?	저희 매장은 1인 1잔이 기본입니다.
쿠키프라페에 휘핑 들어가있나요?	들어가있습니다.
휘핑 빼주실 수 있나요?	당연하죠~
그러면 아메리카노 하나랑 쿠키프라페 휘핑빼고 하나주세요	아메리카노 뜨거운건가요?
아이스로 주세요	지금은 아이스가 안됩니다.
아메리카노 주세요	따듯하게 드릴까요?
차갑게 주세요	4천원입니다
허니브레드는 얼마에요?	7천원입니다
얼마나 걸려요?	10분 정도 걸려요
포장도 되나요?	네
아이스 아메리카노 한 잔 가능한가요?	네. 가능합니다.
헤이즐넛 시럽도 조금넣어 주실 수 있나요?	헤이즐넛 시럽은 500원 추가됩니다.
그럼 사이즈업은 얼마 추가인가요?	500원 추가하면 가능합니다.
포인트 적립해 주세요.	쿠폰 주시면 도와드리겠습니다.
매장에서 테이크아웃잔 사용 가능한가요?	아뇨, 매장에서는 머그컵만 사용 가능합니다.
카페라테 한 잔 주세요	네 카페라떼 컵 사이즈는 뭘로 드릴까요?
카페라떼 제일 큰 사이즈로 주세요	네 그럼 카페라떼 톨 사이즈로 드리겠습니다
베이글도 하나 부탁드려요	베이글 크림은 어떤 걸로 드릴까요?
베이글 크림은 어떤 게 있나요?	어니언 크림이랑 플레인 크림 있습니다
어니언 크림으로 부탁드릴게요	네 준비해드리겠습니다
아이스 아메리카노 한 잔 주세요	아이스 아메리카노 포장이신가요?
아니요 매장에서 먹을게요	머그잔으로 제공해드려도 괜찮을까요?
네 그렇게 해주세요	아이스 아메리카노 한 잔에 5000원입니다
네 여기 오천 원이요	현금영수증 필요하세요?
아니요 현금영수증 괜찮아요	진동벨 울리면 찾으러 오시면 됩니다
음료 사이즈 업 가능한가요?	네 가능합니다
아이스 아메리카노 사이즈 업해주세요	아이스 아메리카노 4000원입니다
아이스 아메리카노에 샷이 몇 개 들어가죠?	아이스 아메리카노에 샷은 세 개 들어갑니다
아이스 아메리카노에 샷 하나 더 추가할게요	사이즈 업 아이스 아메리카노에 샷 추가 맞으시죠?
네 맞습니다	총 4500원입니다
아메리카노 한 잔 주세요	네 아메리카노 어떤 걸로 드릴까요?
아이스 아메리카노요	네 아이스 아메리카노로 한 잔 드릴게요
음료 한 잔 더 추가되나요?	네 말씀 하세요
바닐라라테도 하나 주세요	바닐라라테 따뜻한 거요?
네 바닐라라테 따뜻한 걸로 주세요	네 알겠습니다
카페라테 한 잔 주세요	카페라테 따뜻한 걸로 드릴까요?
네 카페라테 디카페인 되나요?	네 카페라테 디카페인 500원 추가됩니다
네 카페라테 디카페인으로 주세요	진동벨이 울리면 받으러 오세요
네 감사합니다	따뜻한 카페라테 한 잔 나왔습니다
카페라테 디카페인 맞나요?	네 맛있게 드세요
자몽에이드 한 잔 얼마에요?	6000원이에요
자몽에이드 사이즈업 되나요?	네 자몽에이드 사이즈업 가능해요
생크림 케이크는 뭐가 제일 맛있어요?	과일 생크림 케이크가 잘 나가요
자몽에이드랑 과일 생크림 케이크 주세요	드시고 가시나요?
포장 가능하죠?	네 준비해드릴게요
아이스 프라푸치노 주세요	네 아이스 프라푸치노 몇 잔 드릴까요?
아이스 프라푸치노 한 잔이요	아이스 프라푸치노 사이즈는 어떻게 드릴까요?
아이스 프라푸치노 그란데 사이즈로요	아이스 프라푸치노에 휘핑크림 올려드릴까요?
아뇨	매장 안에서 드실 건가요?
아뇨	네 멤버십 카드와 결제수단 함께 제시해 주세요
새벽에도 영업해요?	24시간 영업하고 있어요
아메리카노 한 잔 주세요	음료 사이즈 말씀해주세요
아메리카노 라지 사이즈요	추가하실 건 없으세요?
네 화장실은 어디에요?	화장실은 복도로 나가시면 보여요
와이파이 비밀번호는 뭐예요?	와이파이 비밀번호는 종이에 써져있습니다
딸기 스무디 되나요?	지금은 재료가 다 떨어져서 딸기 스무디는 어렵습니다
따뜻한 라테 한 잔 주세요	드시고 가시나요?
아니요 가져갈게요	네 더 필요하신 건 없으신가요?
이 쿠키도 함께 주세요	네 쿠폰 찍어드릴까요?
네 찍어주세요	네 주문하신 딸기 스무디와 쿠키 드릴게요
시즌 메뉴 오늘도 가능한가요?	네 시즌 메뉴 가능합니다
프리퀀시 적립하고 있는데 시즌 메뉴도 하나만 적립되나요?	네 그렇습니다
시즌 메뉴와 함께 구성되어 있는 세트 메뉴가 있나요?	네 치즈 케이크와 시즌 메뉴 두 잔으로 구성된 세트 메뉴 있습니다
기프티콘도 세트메뉴에 사용 가능한가요?	아니오 세트 메뉴에는 기프티콘 사용이 불가능합니다
이 기프티콘으로 대체할 수 있는 시즌 메뉴는 무엇인가요?	기프티콘으로 대체할 수 있는 시즌 메뉴는 없습니다
라테에 우유 대신 두유로도 변경 가능한가요?	네 라테에 두유로 변경 가능합니다
그럼 두유로 바꿔서 카페라테 두 잔 주세요	카페라테 사이즈는 어떻게 드릴까요?
카페라테 라지로 주세요	드시고 가실 건가요?
아니요 가져갈 거예요	네 진동벨 울리면 와주세요
커피 캐리어도 주실 수 있나요?	네 캐리어에 담아 드릴게요
저 따뜻한 아메리카노 한 잔하고 아이스 라테 한 잔 주세요	더 필요한 건 없으시고요?
이 치즈케이크도 한 조각 주세요	여기서 드실 건가요?
네 먹고 갈 거예요	카드 여기 꽂아 주세요
네 몇 분 정도 걸릴까요?	주문이 밀려서 7분 정도 걸릴 거예요
네 2층이 넓은가요?	네 2층에 자리 많아요
카페인이 들어있지 않은 음료 있나요?	티 음료와 스무디에는 카페인 성분이 들어가지 않습니다
스무디 한 잔 주세요	플레인스무디 딸기스무디 키위스무디 중에 선택해 주세요
딸기스무디랑 키위스무디는 생과일인가요?	딸기는 냉동 제품이고 키위는 생과일을 사용하고 있습니다
그럼 딸기 스무디 하나 주세요	드시고 가시나요?
네 매장에서 마실 거예요	머그잔에 드릴게요
아메리카노 한 잔이요	아이스 아메리카노로 드릴까요?
아니요 아메리카노 뜨거운 걸로 주세요	드시고 가시나요?
네 그렇습니다	머그잔 괜찮으세요?
네 휴지도 같이 주시겠어요?	네 아메리카노 4000원입니다
여기 포인트도 적립되나요?	네 그럼요
디카페인 커피도 판매하나요?	네 저희 매장에서는 디카페인과 하프 디카페인 중에 선택하실 수 있습니다
디카페인 아이스 아메리카노 한 잔 주세요	디카페인 아이스 아메리카노는 기존 금액에 300원 추가되는데 괜찮으신가요?
괜찮습니다	추가로 필요하신 건 없나요?
치즈케이크도 한 조각 주세요	네 총 9500원 결제해드리겠습니다
영수증 챙겨주세요	결제 완료되셨고 영수증 여기 있습니다
커피음료 아닌 것 뭐가 있나요?	스무디와 주스 있습니다
주스 어떤 종류 있나요?	딸기주스 바나나주스 파인애플주스가 있습니다
딸기 주스로 주세요	네 더 필요한 건 없으세요?
당근 케이크 같이 주세요	네 알겠습니다
카드 결제할게요	네 카드 받았습니다
플랫 화이트가 뭔가요?	플랫 화이트는 카페라테보다 우유 양이 좀 적게 들어갔어요
플랫 화이트 한 잔 주세요	신 맛과 고소한 맛 원두 중에 어떤 걸로 드릴까요?
고소한 맛 원두로 부탁드릴게요	플랫 화이트 사이즈는 뭘로 하시겠어요?
플랫 화이트 라지로 주세요	네
얼마인가요?	플랫 화이트 4500원입니다
치즈케이크 있나요?	아니요 치즈케이크는 지금 없어요
네 레드벨벳 케이크 주세요	음료는 뭘로 드릴까요?
아이스 아메리카노 두 잔 주세요	드시고 가시나요?
네 먹고 갈 거예요	유리잔 괜찮으세요?
네 괜찮아요	네 총 14500원입니다
차 종류는 어떤 게 있나요?	차 종류는 루이보스랑 블랙 티 있어요
페퍼민트는 없나요?	죄송합니다만 페퍼민트는 방금 전에 다 떨어졌어요
카페인이 적고 따뜻한 다른 음료 좀 추천해주세요	루이보스차나 밀크티 종류는 어떠세요?
밀크티는 티를 직접 우려서 나오는 건가요?	네 밀크티는 블랙 티를 우려서 만들고 있어요
따뜻한 밀크티 주세요	네
아이스 아메리카노 한 잔 주문할게요	네 알겠습니다
음료 받으려면 얼마나 기다려야 하나요?	10분 정도 기다려 주시면 됩니다
치즈 케이크는 지금 없나요?	네 치즈케이크는 지금 다 팔렸습니다
티라미슈도 주세요	네 진동벨 울리면 찾으러 오세요
앞접시도 주실 수 있으신가요?	네 앞접시도 같이 드리겠습니다
아이스 아메리카노 한잔 얼마인가요?	4500원입니다
따뜻한 아메리카노 한 잔은 얼마인가요?	4100원입니다
그러면 따뜻한 아메리카노 한 잔과 아이스 아메리카노 한 잔 포장해 주세요	네 현금영수증 필요하세요?
네 현금영수증 해주세요	현금영수증 번호 눌러주세요
현금영수증 번호 눌렀습니다	네 고맙습니다
매장 영업 몇 시까지 하나요?	매장 영업 시간은 12시까지라 지금은 테이크아웃만 가능하세요
마감 다 하실 때까지 앉아있다 가면 안 되나요?	네 바닥 청소도 해야 해서 죄송합니다
아이스 아메리카노 두 잔 주세요	네 총 8000원입니다
아이스 아메리카노 한 잔에만 시럽 넣어주세요	네 알겠습니다
이 카드로 결제해주세요	네 결제 도와드릴게요
와이파이 되나요?	와이파이 암호는 ****입니다
화장실이 어디예요?	화장실은 2층에 있습니다
주문한 게 다 안 나왔어요	주문번호가 몇 번이죠?
커피 말고 다른 음료는 없나요?	티와 주스가 있습니다
추운데 에어컨을 줄여주시겠어요?	중앙냉방이라 곤란합니다
아아에 샷 추가 부탁드려요	네 커피가 많이 진할 수 있는데 괜찮으신가요?
네 결제는 삼성페이로 할게요	포인트 적립 카드 있으신가요?
네 휴대폰 번호 입력할게요	네 번호 입력해주세요
카페는 몇 시까지 하나요?	11시까지 합니다
아아에 얼음 많이 넣어주세요	네 다 되면 진동벨로 알려드릴게요
아메리카노 기프티콘 사용할 수 있나요?	네 가능하세요
아메리카노 기프티콘 사용해주세요	바코드를 앞에 기계에 대어주세요
기계 바코드 인식이 잘 안되는데요	제가 해드리겠습니다
네 기프티콘 여기 있어요	아메리카노 기프티콘 사용되었습니다
감사합니다	픽업은 오른쪽에서 하시면 됩니다
오늘의 커피는 뭔가요?	아메리카노와 카페모카입니다
카페모카 주세요	휘핑크림 올려드릴까요?
아니요 그냥 주세요	카페모카 5천 원입니다
카드로 할게요	네 잠시만 기다려주세요
빨대는 어디 있나요?	네 이쪽에 있습니다
샌드위치랑 카페라테 주세요	커피는 따뜻하게 드릴까요?
네 샌드위치도 데워주실 수 있죠?	그럼요
물티슈도 챙겨 주세요	네 드시고 가시나요?
네	커피는 머그에 준비해 드려도 될까요?
네 괜찮아요	준비되면 불러드리겠습니다
단체 주문 가능한가요?	물론이죠
아이스 아메리카노 30개 주세요	네 단체 주문은 재료 추가 불가능합니다
라테 20개 주문할게요	총 50개 주문받았습니다
그럼 한 시간 후에 음료 찾으러 오면 될까요?	네 계산 도와드릴게요
포인트랑 쿠폰 적립해주세요	다 되셨습니다
커피와 조각 케이크 세트로 판매하시나요?	네 있습니다
세트 종류가 어떤 게 있죠?	이쪽에서 고르시면 됩니다
아메리카노 티라미슈 세트 가격은 어떻게 되죠?	아메리카노 티라미슈 세트 가격은 만 원입니다
아메리카노를 카페모카로 변경 가능한가요?	가능합니다만 가격이 천 원 더 올라가게 됩니다
그러면 아메리카노 티라미슈 세트에 카페모카로 변경해서 주문하겠습니다	네 잠시만 기다려주세요
아이스 아메리카노 되나요?	네 가능합니다
얼음량 조절 적게 되나요?	네 가능합니다
베이글은 얼마인가요?	베이글은 2000원입니다
머핀은 얼마에요?	베이글과 동일하게 2000원입니다
베이글과 머핀 전부 주세요	준비해드리겠습니다
지금 빙수 되나요?	빙수는 계절메뉴라 지금은 판매하지 않습니다
그럼 아메리카노랑 바닐라 라테 주세요	둘 다 아이스인가요?
바닐라 라테는 따뜻하게 주세요	네 적립이나 할인되는 카드 있으세요?
네 여기 있습니다	손님 지금 15000포인트 있으신데 사용해 드릴까요?
아니요 그냥 적립만 해주세요	네 적립되셨습니다
기프트카드 포인트 결제되나요?	네 됩니다
혹시 기존 카드로 통합 시킬 수도 있나요?	네 합쳐 드릴까요?
네 합쳐주시고 아이스 아메리카노 한잔 주세요	드시고 가실 건가요?
먹고 갈 건데 혹시 일회용 컵에 담아주실 수 있을까요?	매장에서 드실 거면 머그컵에 드리도록 되어있습니다
마시다 나갈 거니 일회용 컵에 담아주실 수는 없을까요?	네 일회용 컵에 담아 드리겠습니다
아메리카노 하나 주세요	따뜻한 걸로 드릴까요?
아니요 아이스로 주세요	레귤러 사이즈로 괜찮으세요?
네 괜찮습니다	매장에서 드시고 가시나요?
테이크 아웃으로 부탁드립니다	결제는 이쪽에서 도와드릴게요
네 알겠습니다	준비가 되면 불러 드릴게요
초코 라테 한잔 주세요	휘핑크림 올려드릴까요
네 많이 올려주세요	알겠습니다
혹시 테이크 아웃 잔에 받을 수 있나요	테이크 아웃하시는 건가요
아니요 여기서 먹을 건데요	그러면 머그잔에 드려야 합니다
그럼 그렇게 주세요	진동벨 울리면 찾으러 오세요
아메리카노 한 잔 주세요	따뜻한 것과 아이스 중에 무엇을 드릴까요?
아이스로 주세요	네 시럽 넣어드릴까요?
아니요 시럽은 빼주세요	네 드시고 가실 건가요?
아니요 테이크 아웃이요	네 1500원 결제 도와드리겠습니다
여기 카드로 결제해주세요	네 알겠습니다
아메리카노 두 잔이랑 치즈케이크 한 개 주세요	아메리카노 두 잔 치즈케이크 한 개 주문 도와드리면 될까요?
아메리카노 하나는 샷 추가해주세요	아메리카노는 둘 다 따뜻한 걸로 드릴까요?
네 따뜻하게 해주세요	다해서 10900원입니다
쿠폰 찍어주세요	네 찍어드릴게요
현금영수증도 해주시죠?	네 영수증 드릴게요
주문할게요	어떤 거 드릴까요
아메리카노 따뜻한 거 라지 사이즈로 주세요	다른 건 필요 없으신가요?
티라미수 케이크도 주세요	적립카드 있으신가요?
번호로 할게요	주차는 하셨나요
주차 안 했어요	진동벨로 알려드리겠습니다
팥빙수 파나요?	팥빙수는 계절음식이라 지금은 안되세요
자몽차는 있나요?	네 자몽차는 있습니다
그럼 자몽차 한잔 주세요	따뜻하게 드릴까요?
네	영수증 드릴까요?
아니요 버려주세요	와이파이 비밀번호는 테이블에 적혀있습니다
저번에 와서 먹은 미숫가루 라테가 오늘은 없네요?	네 그건 시즌 한정 메뉴라 겨울에는 판매하지 않습니다
그럼 겨울 메뉴로는 뭐가 맛있나요?	겨울엔 감귤 라테가 제일 많이 나가요
사이드 메뉴 중엔 맛있는 게 뭔가요?	인절미 쏙쏙 붕어빵이 인기에요
그럼 감귤 라테 2잔이랑 인절미 쏙쏙 붕어빵 2개 주세요	드시고 가시나요?
네 결제는 카드로 할게요	네 결제 완료되었습니다
아메리카노 한잔 주세요	따뜻한 걸로 드릴까요?
아이스 아메리카노로 주세요	아이스 아메리카노 한잔 주문 도와드리겠습니다
초코머핀도 하나 추가해주세요	초코머핀 어떤 걸로 드릴까요?
화이트로 부탁해요	아이스 아메리카노 한잔 화이트초코머핀 1개 주문 도와드리겠습니다
얼마예요?	총 7000원입니다
아메리카노 한 잔이랑 바닐라 라테 한 잔 주세요	둘 다 따뜻한 거 맞으세요?
아니요 아메리카노는 아이스로 주세요	네 음료 사이즈는 어떤 걸로 하시겠어요?
둘 다 스몰 사이즈로 할게요	네 결제는 어떤 것으로 도와드릴까요?
기프티콘으로 결제할게요	네 그럼 쿠폰 저에게 보여주세요
여기 쿠폰이요	네 고객님 결제 완료되었습니다
녹차라테 1잔 주세요	따뜻한 걸로 드릴까요?
네 따뜻한 걸로 주세요	드시고 가시나요?
네 여기서 먹고 갈 거예요	그럼 머그잔에 드릴게요
혹시 휘핑크림 추가되나요?	네 500원 추가하시면 추가돼요
네 그럼 휘핑크림 추가해서 주세요	네 녹차라테에 휘핑크림 추가해서 4500원입니다
브레드 종류는 뭐가 있나요?	허니 브레드와 갈릭 치즈 브레드가 있습니다
생크림이 올라가는 건 어떤 건가요?	허니 브레드입니다
갈릭 치즈 브레드에 생크림을 올려주실 수는 없나요?	500원의 추가 비용이 발생되는데 괜찮으세요?
네 그렇게 만들어 주세요	더 필요한 건 없으세요?
아이스 바닐라 라테도 한 잔 주세요	네 진동벨이 울리면 픽업대로 와주세요
라테 한 잔에 얼마인가요?	5000원입니다
마카롱은 남아있나요?	오늘은 다 팔렸어요
그러면 스콘 하나랑 라테 한 잔 주세요	네 적립 쿠폰 주시면 적립해드릴게요
혹시 적립 쿠폰으로 커피 계산할 수 있나요?	네 됩니다
그러면 커피는 쿠폰으로 스콘은 카드로 계산해주세요	알겠습니다
아이스 아메리카노에 얼음 조금 덜 넣어주실 수 있나요?	네 또 더 필요한 거 있으세요?
네 블루베리 스무디 1개 더 추가로 주세요	드시고 가시나요?
아니요 테이크아웃이요	네 포인트 적립하시나요
아니요 기프티콘으로 결제할게요	저한테 보여주시고 제가 확인 버튼 누르면 돼요
여기 있습니다	네 확인되셨고 차례되면 진동벨 울리실 거예요
핫초코 파나요?	네 4500원입니다
핫초코 한잔 아메리카노 한잔하면 얼마인가요?	9500원입니다
사이즈업 되나요?	아메리카노만 사이즈업 가능하십니다
핫초코 한 잔 아메리카노 사이즈업한 잔 하면 얼마인가요?	10000원입니다
레몬티도 파나요?	네 4500원입니다
제일 맛있는 케이크가 뭐예요	치즈 케이크가 잘 팔려요
한 조각에 얼마죠	4000원입니다
그거랑 아메리카노 주세요	사이즈 선택해주세요
라지 사이즈로 주세요	총 8800원입니다
카드로 결제할게요	영수증 드릴게요
저 아메리카노에 샷 추가해서 주세요	저희 투 샷으로 들어가는데 샷 추가해드릴까요?
네 4샷으로 넣어주세요	네 4000원입니다
저 카카오페이로 결제할게요	결제 완료되었습니다
아 저 이 티라미수도 하나 주세요	네 티라미수는 4500원입니다
네 두 개 함께 가져다주세요	네 감사합니다
제가 커피를 못 마시는데 음료 좀 추천해주세요	그럼 생과일주스가 어떠신가요
주스는 너무 달아서 싫은데 다른 건 없나요	그럼 이번에 나온 오곡 라테 추천해드려요
그건 달지 않나요?	네 곡물가루만 넣어서 고소하고 따듯해요
통신사 할인되죠?	네 300원 할인됩니다
카드로 결제할게요	네 감사합니다
디카페인 음료 주문 가능할까요?	네 디카페인 라테 아메리카노 주문 가능합니다
그럼 디카페인 라테 한잔해주세요	네 다른 필요하신 건 없으신가요?
멤버십으로 사이즈업해주세요	네 사이즈업 도와드리겠습니다
매장에서 마시려는데 언제까지 영업하시나요?	오후 10시까지 영업입니다
네 엘지 파이로 계산할게요	네 엘지 파이로 결제 도와드리겠습니다
플렛 화이트 아이스도 있나요?	네 있습니다
머핀이나 케이크도 있나요?	네 초코머핀이랑 치즈케이크 있습니다
그럼 초코머핀 하나 주세요	초코머핀 데워 드릴까요?
아니요 그냥 주세요	결제해드릴게요
기프트콘 사용 가능하나요?	네 가능합니다
바닐라라테 진하게 가능할까요?	네 그럼 시럽 많이 넣어드릴게요
아이스인데 얼음 없이 줄 수 있으세요?	얼음 아예 빼는 건 안되고 최대한 조금 넣어드릴게요
쿠폰 10개 다 모았는데 사용 가능할까요?	쿠폰은 아메리카노만 사용 가능하세요
가격 차감으로는 안 되나요?	한 번만 해드릴게요
조금만 앉아있다가 나갈 건데 일회용 컵에는 안될까요?	앉아계실 거면 컵만 가능하세요
카페라테 한잔 주세요	따뜻한 걸로 드릴까요?
아이스로 주세요	드시고 가시나요?
아니요 가지고 나갈 거예요	포인트 적립하시나요?
아니요 그냥 결제해주세요	결제 도와드리겠습니다
현금으로 할게요	현금영수증 해드릴까요?
아메리카노 한 잔 주세요	아이스로 드릴까요?
네 차가운 걸로 주세요	4500원입니다
이 쿠키는 뭐예요?	초코칩 쿠키입니다
이것도 하나 주시는데 얼마에요?	2000원입니다
네 여기 현금영수증도 해주세요	네 번호 적어주세요
아이스 아메리카노 하나 따뜻한 자몽치 하나 주세요	아메리카노 원두는 어떤 걸로 할까요?
어떤 게 괜찮아요?	보통 여자분들이나 특정 원두를 선호하시는 게 아니면 예가체프 많이 추천해드려요
많이 쓴가요?	쓴맛은 많이 없고 산미가 있고 다른 원두들보다 과일향이 나죠
그러면 예가체프로 주세요	부드러워서 아메리카노 안 좋아하시는 분들도 많이 선택하세요
테이크 아웃으로 해주세요	네 진동벨 울리면 픽업 테이블로 와주세요
아이스 말차 라테에 에스프레소 샷 하나 추가해서 주세요	네 따로 추가하실 건 없으신가요?
지금 말차 케이크는 품절인 거죠?	네 죄송하지만 말차 케이크는 품절되었습니다
그럼 말차 라테에 잘 어울리는 케이크 하나 추천해주시겠어요?	치즈 케이크가 잘 어울려서 같이 주문하시는 고객님들이 많으세요
그럼 추천해주신 치즈 케이크도 같이 주세요	네 매장에서 드시고 가시나요?
네 매장에서 먹고 갈게요	네 그럼  바로 준비해드리겠습니다
그린 티 프라푸치노 하나 주세요	네 사이즈는 어떻게 드릴까요?
그리고 휘핑크림은 에스프레소 크림으로 올려주세요	결제는 어떻게 해드릴까요?
스타벅스 카드로 계산할게요	사용하시고 잔액 3천 원인데 충전하시겠어요?
네 2만 원 충전해주세요	네 알겠습니다
에스프레소 한 잔하고 카페모카 두 잔 주세요	카페모카 사이즈는 어떤 걸 드릴까요
그랑데 사이즈로 주십시오	드시고 가실 건가요
네	전부 1만 3천 원입니다
할인카드 있습니다	할인되어 1만 1천 원입니다
할인율이 높군요	감사합니다
핫초코에 우유를 더 많이 타서 연하게 만들어주실 수 있나요?	네 그렇게 해드리겠습니다
얼마인가요?	5천 원입니다
아이스로 변경할 경우 추가요금이 있나요?	아이스 음료는 500원이 더 비쌉니다
그냥 따뜻한 걸로 주시고 따뜻한 아메리카노도 한잔 더 주실 수 있나요?	들고 가실 건가요?
네 안전히 들고 갈 수 있게 부탁드립니다	손잡이 있는 캐리어에 담아드리겠습니다
밀크티 한 잔 얼마에요?	4500원입니다
사이즈업 되나요?	네
케이크는 뭐가 제일 맛있어요?	요즘은 초코 케이크가 제일 잘나가요
초코 케이크 한 조각 주세요	네 더 필요하신 건 없으세요?
현금 영수증 해주세요	네 번호 찍어주세요
카페라테 가격은 얼마인가요?	5000원입니다
멤버십 있는데 포인트 쓸 수 있나요?	네 포인트 사용 가능하세요
포인트 사용하고 적립 동시에 가능한가요?	포인트 사용하시면 적립은 안됩니다
포인트 사용 없이 적립만 할게요	네 멤버십 카드 주시면 도와드리겠습니다
멤버십 카드 드리고 현금으로 계산할게요	네 현금영수증 해드릴까요?
아이스 아메리카노 주세요	샌드위치는 안 필요하신가요?
지금도 브런치 할인하나요?	네 10시까지 하고 있습니다
그럼 크로크무슈와 아이스 아메리카노로 할게요	더 필요하신 건 없나요?
네 할인돼도 적립은 해주죠?	네 바코드 보여주세요
현금영수증도 할게요	네 번호 입력해주세요
민트 초코 프라푸치노 주세요	휘핑 올려드릴까요?
탑처럼 쌓아주세요	알겠습니다
민트 시럽도 코가 찡할 만큼 올려주세요	드시고 가시나요?
포장이요	5500원입니다
적립도 해주세요	알겠습니다
아이스 아메리카노 하나랑 녹차라테 주세요	녹차라테도 아이스로 드릴까요?
녹차라테는 따뜻하게 주세요	사이즈는 어떻게 드릴까요?
둘 다 스몰 사이즈로 주세요	드시고 가시나요?
마시다가 들고나갈 건데 테이크아웃으로 주세요	규정상 매장에서는 머그컵으로 드리고 있어요
나갈 때 테이크아웃 컵으로 옮겨줄 수 있나요?	네 그렇게 해드릴게요
아메리카노 두 잔 마키아토 한잔 주세요	드시고 가실 건가요
테이크아웃 잔으로 주세요	올해부터는 점포 안에서 1회용을 사용하실 수 없습니다
네 머그잔으로 주세요	마키아토 휘핑 올려드릴까요
무료인가요	500 원 추가입니다
추가해주세요	자리에 앉아 계시면 가져다드리겠습니다
아메리카노 교환권이 있는데 다른 걸로 바꿀 수 있을까요?	가능한데 어떤 걸로 바꿔드릴까요?
카페라테로 교환해주세요	사이즈는 어떤 걸로 해드릴까요?
통신사 쿠폰 사용해서 라지 사이즈로 해주세요	이곳에 바코드 찍어주세요
추가요금은 얼마인가요?	500원 결제해주시면 됩니다
이 카드로 해주세요	음료 나오면 진동벨로 알려드리겠습니다
아이스 아메리카노 1잔이랑 아이스 카페라테 1잔 얼마인가요?	아이스 아메리카노 1잔은 4000원 아이스 카페라테 1잔은 5000원입니다
멤버십 할인되나요?	네 멤버십 할인하시면 10퍼센트 할인됩니다
기프티콘 있는데 쓸 수 있나요?	네 유효기간 내라면 사용 가능하세요
여기에서 지하철 타려면 어느 역으로 가야 하나요?	분당선 압구정 로데오 역을 이용하시면 됩니다
여기 주차되나요?	건물 뒤에 주차장 있습니다
쿠앤크 치노 하나요	아이스로 드릴까요?
네 아이스요	드시고 가세요?
네 먹고 가요	계산은 어떻게 하실 건가요?
여기 카드로 결제해주세요	네 결제해드렸습니다
얼마나 기다려야 하나요?	5분 정도 기다리세요
카페인 안 들은 음료는 뭐가 있을까요?	피지와 나 티 종류가 있습니다
피지와는 어떤 게 있어요?	라임하고 자몽이 있습니다
둘 중에 어떤 게 더 잘 나가요?	자몽이 조금 더 잘 나가요
자몽 피지와 주세요	네 더 필요하신 건 없으세요?
포인트 적립해주세요	네 번호 입력 부탁드립니다
티 종류도 아이스 가능한가요?	네 고객님 티 종류 다 아이스 가능합니다
그럼 캐머마일 아이스로 하나 주세요	네 고객님 사이즈는 톨 사이즈 괜찮으신가요?
네 괜찮아요	네 고객님 포인트 적립하시겠어요?
네 번호로 할게요	네 앞쪽에 번호 눌러주세요
아 포인트 있으면 포인트 사용해주세요	네 고객님 포인트 총 5000점 있으신데 그중 4500점 사용 도와드리겠습니다
화이트 모카 한 잔 주세요	드시고 가세요?
아뇨 테이크아웃이요	휘핑 올려드릴까요?
네 올려주세요	따뜻한 걸로 드릴까요 차가운 걸로 드릴까요?
따뜻한 걸로 주세요	사이즈는 어떻게 드릴까요?
톨 사이즈로 주문할게요	네 계산 도와드리겠습니다
아이스 아메리카노 하나랑 카페모카 하나 주세요	카페모카도 아이스 맞으세요?
카페모카는 따뜻한 거로 주세요	카페모카 위에 휘핑 올려드릴까요?
많이 올려주세요	테이크아웃이세요?
여기서 먹고 갈 거예요	매장에서 드시면 일회용 컵에 제공되지 않는데 괜찮으세요?
괜찮아요	준비되면 진동벨로 알려드릴게요
아직 런치세트 할인되나요?	네 2시까지 가능하십니다
치킨 파야냐 하나랑 아이스 아메리카노 하나 해서 주세요	네 더 추가하실 것은 없으신가요?
아메리카노 사이즈 업도 가능한가요?	네 500원만 추가하시면 가능하십니다
사이즈업해서 주세요	네 결제는 어떻게 도와드릴까요?
삼성페이 되나요?	네 가능합니다
리저브는 처음인데요	네 원하시는 원두와 내리는 방법을 선택하실 수 있습니다
네 평소에 아메리카노를 주로 마시는데요	네 과테말라와 케냐를 섞은 마이크로 블렌드를 추천하겠습니다
어떤 맛인가요	다크초콜릿이 어우러진 달콤한 맛입니다
전 단것은 별로인데요	아주 단맛이 아닌데요
그럼 커피와 어우러지는 케이크도 추천해 주세요	상큼 한 블루베리 머핀이나 레드벨벳 크림치즈케이크가 어울립니다
카페라테 주세요	네 드시고 가시나요?
아니요 테이크아웃이요	네 알겠습니다
커피는 텀블러에 담아주세요	네 텀블러 할인되셔서 4000원 결제 도와드리겠습니다
네 카드 여기요	적립 쿠폰 있으세요?
아니오 하나 만들어 주세요	네 카드랑 쿠폰 여기 있습니다
아메리카노 1잔 주세요	매장에서 드시고 가시나요?
바닐라라테를 두유로 바꿔서 만들어주세요	네 알겠습니다
2잔 주문하면 얼마죠?	7000원입니다
모카 라테 1잔 주세요	휘핑크림 올려드릴까요?
치즈케이크 하나 추가해주세요	네 알겠습니다
아메리카노 두 잔 주문할게요	아메리카노 따뜻한 건가요?
아니요 아이스 아메리카로 주세요	드시고 가실 건가요?
테이크아웃할게요	지금 행사 중인데 케이크 주문하시면 아메리카노 한잔 공짜로 드려요
치즈 케이크 하나같이 주문할게요	네 아이스 아메리카노 두 잔 치즈 케이크 주문받았습니다
저희 그냥 먹고 가겠습니다	네 벨 울리면 가지러 와주세요
키오스크에서 현금 결제가 안 되네요	현금은 카운터에서 주문 도와드리겠습니다
아이스 아메리카노 한 잔이랑 스콘 하나 할게요	드시고 가세요?
아니요 포장이요	스콘은 데워드릴까요?
네 부탁드릴게요	더 필요한 건 없으신가요?
도장 찍어주세요	네 이리 주세요
여기 카페인 안 들어간 게 있나요?	루이보스랑 유자차 있어요
유자차 차갑게 주문 가능한가요?	유자차는 안되고 루이보스는 아이스로 가능하세요
그럼 루이보스 차갑게 하나랑 유자차 하나 할게요	네 포인트나 할인카드 있으세요
네 여기 KT 더블할인되죠?	할인 적용해서 9300원 결제 도와드릴게요
네 여기 카드 있습니다	여기 진동벨 가지고 계시다가 울리면 주문한 음료 가져가세요
고구마라테 아이스도 되나요?	고구마라테는 따뜻하게만 돼요
카페 와이파이 비밀번호 알 수 있을까요?	****입니다
쿠폰 몇 개를 모으면 무료로 아이스커피를 마실 수 있어요?	쿠폰 10개를 모으면 무료로 아이스 아메리카노를 제공하고 있어요
포인트 적립되나요?	휴대번호 알려주시면 포인트 적립 도와드리고 있어요
카페 몇 시까지 해요?	오후 10시까지 합니다
오픈이 몇 시인가요?	9시부터 열어요
캐러멜 프라푸치노주세요	다른 사항은 없으신가요?
휘핑크림에 캐러멜 드리블이랑 통 잡아 칩 깔아주세요	다시 말씀해주시겠어요?
캐러멜 드리블이랑 통 잡아 칩이요	6700원 결제 도와드리겠습니다
포인트 적립할게요	네 결제되셨습니다
아이스 아메리카노랑 밀크티 차가운 거랑 치즈케이크 하나 주세요	지금 치즈케이크가 다 팔려서요
티라미수는 있나요?	네 티라미수는 있습니다
그럼 그걸로 할게요	네 총 18000원입니다
네 현금영수증 해주세요	네 드시고 가시나요?
네 먹고 갈게요	유리잔에 드릴게요
아메리카노 아이스로 하나요	사이즈는 뭘로 드릴까요
작은 사이즈로 주세요	추가하시는 건 없으시고요
쿠키도 주세요	멤버십 있으신가요
아뇨 그냥 주세요	할인 카드도 안 하시나요
할인 카드는 드릴게요	네
아메리카노 하나요	따뜻한 거 맞으세요?
아니오 아이스로 주세요	네 저희꺼 적립카드 있으세요?
아니오 하나 만들어주세요	네 여기 있습니다
샷 추가해주세요	네 알겠습니다
카드 결제할게요	네 앞에 카드 꽃아주시면 됩니다
맨날 먹던 걸로 한잔 줘요	죄송하지만 어떤 거 드셨죠?
나 여기 매일 왔는데 나 몰라요?	죄송하지만 오늘이 처음이라서요
아메리카노 한잔 줘요	따뜻한 걸로 드릴까요?
이 날씨에 차가운 거 먹어요?	따뜻한 아메리카노 한잔 준비해드리겠습니다
얼마에요?	만 원입니다
아메리카노 2잔 주세요	따뜻한 거로 드릴까요?
하나는 따뜻한 거 하나는 차가운 거로 주세요	드시고 가시나요?
조금 마시다가 갈 거에요	가실 때 말씀해주시면 테이크 아웃 잔에 드릴 테니 우선 머그잔에 드리겠습니다
여기 쿠폰 도장 찍어주세요	2개 찍어드렸고 진동벨로 알려드리겠습니다
그리고 미지근한 물도 1잔만 부탁드려요	같이 준비해드리겠습니다
아이스 아메리카노 두 잔이랑 말차 케이크 한 개 주세요	포장이신가요?
아니요 먹고 갈 거예요	포크는 몇 개 드릴까요?
두 개 주세요	먹고 가시는 거면 유리잔 괜찮으실까요?
얼마 안 있고 갈 건데 테이크 아웃 잔에 주시면 안 될까요?	정책상 불가능하고 나가실 때 말씀해주시면 테이크아웃 잔으로 바꿔드릴 수는 있습니다
유리잔에 주세요	네 계산해드리겠습니다
아메리카노 샷 추가로 주세요	테이크아웃인가요?
네 여기 텀블러에 담아주세요	고객님 텀블러 이용하시면 500원 할인됩니다
시럽은 어디 있나요?	고객님 시럽은 왼쪽에 보시면 있습니다
크랜베리 스콘 두 개도 포장해주세요	고객님 살짝 데워드릴까요?
총 금액 알려주세요	스콘 두 개 아메리카노 샷 추가 텀블러 할인해서 9500입니다
아이스 아메리카노랑 샌드위치 주세요	오전 10시 이전에 오셔서 세트 할인 가능하세요
그렇게 해주세요	매장에서 드시고 가세요?
매장에서 먹고 갈 거예요	할인카드 있으신가요?
음료는 텀블러에 담아주세요	텀블러 할인 300원 같이 해드릴게요
네 감사합니다	진동벨로 알려드릴게요
위에 자리 있나요?	네 자리 있습니다
아이스 바닐라라테 두 잔 주세요	크림 올려드릴까요?
하나는 그냥 주시고 하나는 올려주세요	쿠폰 없으시면 만들어 드릴까요?
네 만들어주세요	만 원입니다
카드 여기 있습니다	진동벨로 불러드릴게요
여기 처음 와서 그런데 시그니처 음료나 메뉴가 있나요?	저희 데이바이데이 메뉴가 저희 시그니처에요
데이바이데이가 뭐예요?	저희가 매일매일 원두를 납품받아서 쓰는데 그날 원두 중에 가장 상태가 좋은 걸로 추출해서 내리는 커피입니다
오늘 쓰시는 원두는 뭐죠?	에티오피아 산 예가체프라고 커피의 귀부인이라고 불리는 원두에요
어떤 향이 나나요?	꽃 향이 나며 적절한 산미와 깔끔한 맛이 혼합되어 밸런스가 아주 잘 잡힌 원두에요
그럼 그걸로 한잔 주시겠어요	금방 준비해드릴게요
오늘의 커피는 무엇이죠?	콜롬비아산 원두입니다
미지근하게 되나요?	네 그럼요
머그잔 할인 가능한가요?	네 500원 할인해드립니다
남은 자리는 있나요?	네 2층에 자리 있습니다
쿠폰 찍어주세요	네 쿠폰 주세요
핫 아메리카노 두 잔 주세요	사이즈는 어떤 걸 드릴까요
둘 다 레귤러로 주세요	총 6천 원입니다
치즈 케이크도 하나 주세요	드시고 가실 건가요?
네 먹고 갈 거예요	모두 9천 원입니다
여기 멤버십 할인도 해주세요	할인 카드 받았습니다
아메리카노 한 잔 주세요	따뜻한 걸로 드릴까요?
아이스로 주세요	네 드시고 가시나요?
네 먹고 갈 건데 혹시 테이크아웃 잔에 주시면 안 될까요?	저희 방침 때문에 안에서 드실 경우에는 일회 용기에 드릴 수 없습니다
그냥 머그컵에 주세요	아이스 아메리카노 한 잔에 3000원입니다
여기 카드 드릴게요	혹시 멤버십 카드 있으신가요?
오늘 영업 종료시간이 몇 시인가요?	네 평일은 밤 11시까지입니다
와이파이 되나요?	네 영수증에 비밀번호 있습니다
라테 2잔이랑 치즈케이크 1조각 주세요	한 잔 무료 쿠폰 쓰시겠습니까?
네 그렇게 해 주세요	한 잔 사이즈 업 가능하시네요
그냥 주세요	잠시만 기다려 주세요
아이스 아메리카노 주세요	고객님 크리스마스 행사로 아메리카노와 케이크 세트로 주문하시면 50퍼센트 할인되는데 어떠세요?
케이크는 어떤 게 있나요?	초코무스 케이크와 치즈케이크 블루베리 케이크가 있습니다
아이스 아메리카노랑 블루베리 케이크 세트로 주세요	네 더 필요하신 건 없으세요?
테이크아웃 할게요	네 쿠폰 있으세요?
아니요 하나 만들어주세요	네 결제 도와드리겠습니다
녹차라테 한 잔에 얼마인가요?	5000원이에요
아이스 녹차라테로 가능한가요?	네 가능하세요
마카롱은 종류가 몇 개인가요?	5종류에요
아이스 녹차라테랑 마카롱 종류별로 주세요	네 알겠습니다
테이크아웃 해 갈게요	포장해드릴게요
모카 프 라프 치노 한잔 얼마에요?	6000원입니다
혹시 안에 자바칩 추가 가능한가요?	네 추가해드릴까요?
네 그리고 생크림도 올려주세요	생크림 추가는 따로 500원 받고 있는데 괜찮으신가요?
네 올려주세요	총 6500원 결제 도와드릴게요
삼성페이 결제되나요?	네 가능합니다
아메리카노 숏 사이즈 주세요	따뜻한 거 맞으시죠?
엘지 VIP 할인받을게요	네 바코드 보여주세요
포인트 적립카드 만들 수 있을까요?	네 연락처 알려주시면 바로 만들어 드릴게요
적립해서 머그잔도 받을 수 있나요?	네 만점 적립되면 머그잔과 교환 가능합니다
금액의 몇 프로 적립되나요?	5프로씩 적립됩니다
조각 케이크 포장되나요?	네 가능합니다
어떻게 포장되나요?	최대 3조각씩 한 팩에 포장해드리고 있습니다
진열된 케이크밖에 없나요?	조각 케이크는 진열된 종류만 있습니다
쿠키앤크림하고 초콜릿하고 스트로베리로 해서 포장해주세요	바로 포장해드릴까요?
커피를 마시고 있어서 한 30분쯤 후에 포장 부탁드릴게요	네 알겠습니다
아이스 라테 한잔 주세요	사이즈는 뭘로 해드릴까요?
그란데요	5200원입니다
이 기프티콘 사용되나요?	기프티콘 금액이 결제금액보다 커서 안돼요
얼마가 모자란데요?	300원이요
벤티 사이즈로 주세요	네 200원 더 결제해주세요
바닐라 라테 한잔 주세요	따뜻한 걸로 드릴까요?
시원한 걸로 주세요	네 4500원입니다
바닐라 시럽 절반만 넣어주세요	네 가져다드리겠습니다
커피는 테이크 아웃으로 부탁드려요	네 더 필요한 건 없으세요?
카페 쿠폰 찍어주세요	네 그럼요
아이스 아메리카노 얼마예요?	2000원입니다
학생 할인되나요?	네 가능합니다
콘센트가 있는 자리도 있나요?	네 기둥 옆에 있습니다
케이크는 뭐가 맛있나요?	딸기 케이크가 신선해요
현금영수증 되나요?	네 가능합니다
아이스 아메리카노 샷 추가 가능한가요?	네 샷 추가는 300원입니다
테이크아웃이랑 홀에서 먹는 거랑 가격이 다른가요?	홀에서 먹으면 1000원 추가됩니다
아이스 아메리카노 샷 추가해서 테이크아웃 할게요	네 2300원입니다
영수증은 버려주세요	시럽 넣어드릴까요?
넣지 말아 주세요	네 감사합니다
아이스 카페모카와 허니브레드 주세요	커피는 진하게 약하게 어떻게 해드릴까요?
진하게 해주세요	휘핑크림 얹어드릴까요?
네 많이 얹어주세요	드시고 가세요 포장이세요?
먹고 갈 거예요	머그컵에 드려도 괜찮을까요?
네 그렇게 주세요	허니브레드 때문에 10분 정도 걸리세요
아이스 캐러멜 마시야도 한 잔 얼마인가요?	5000원입니다
휘핑크림 추가되나요?	네 당연하죠
여기 디저트 종류는 어떤 게 인기인가요?	베이글이랑 마카롱 종류가 인기 있어요
치즈베이글도 같이 주세요	네 다른 필요한 건 없으신가요?
네 결제는 카카오 파이로 해도 되나요?	네 됩니다
카페모카 주문돼요?	네 위에 휘핑크림 얹어 드릴까요?
네 커피 맛 별로 안 나게 해주세요	네 할인이나 적립은 안 하세요?
적립 안 하고 포인트 사용할게요	네 앞에 포인트 비밀번호 눌러주세요
주차 할인되나요?	네 영수증 보여드리면 돼요
냅킨은 어디 있어요?	제가 드릴게요
아메리카노 하나요	뜨겁게 해드릴까요?
네 추워서요	드시고 가세요?
아뇨 테이크아웃이요	네 카드로 계산하실 건가요?
여기요	네 포인트 적립도 하실 건가요?
아뇨 필요 없어요	네 몇 분만 기다리세요
주문받아 주실 수 있나요?	네 말씀 해주세요
아이스 아메리카노 얼음 빼고 가능한가요?	음료가 미지근할 수도 있어요
얼음을 평상시보다 반만 넣어주실 수 있나요?	네 해드릴게요
얼음 반만 넣은 아메리카노 2잔 주시겠어요?	아메리카노 2잔 주문받았습니다
캐리어에 담아서 가져갈게요	네 캐리어 담아드릴게요
아메리카노 한 잔이랑 초코 라테 한잔 주세요	둘 다 따뜻하게 드릴까요
아메리카노는 아이스로  초코 라테는 아이가 먹을 거라 미지근하게 해주세요	드시고 가시나요
아니요 캐리어에 담아주세요	지금 주문이 밀려있어서 10분 정도 기다리셔야 하는데 괜찮으세요
네 기다릴게요	아이스 아메리카노랑 초코 라테 미지근하게 하신 분 나왔습니다
냅킨 조금 더 주세요	여기 있습니다
새로 나온 메뉴가 어떤 거였죠?	뱀파이어 프라푸치노입니다
지금 주문 가능한가요?	재료가 다 떨어져서 지금은 주문이 어렵습니다
그냥 아이스 아메리카노로 할게요	테이크아웃 하시나요?
마시고 갈 거예요	네 알겠습니다
포인트 적립은 번호로 입력해도 되나요?	네 가능합니다
이 기프티콘으로 다른 메뉴 변경 가능한가요?	네 대신 기프티콘 금액보다 적은 건 안되세요
로즈 재스민 티 따뜻한 거 하나하고요 적립도 할게요	드시고 가시나요?
아뇨 테이크아웃 할 거예요	적립 바코드 보여주시겠어요?
네	적립되셨고 기프티콘 바코드도 보여주시고요
현금영수증도 부탁드려요	네 번호 불러주세요
아메리카노 한 잔 주세요	따뜻한 거랑 차가운 거 어떤 걸로 드릴까요?
아이스로 주세요	네
혹시 아메리카노 조금만 연하게 타주실 수 있나요?	저희 2샷 들어가는데 샷 하나만 넣어드릴까요?
네 그리고 케이크 종류는 뭐가 있나요?	치즈 케이크랑 초코케이크 두 종류 있어요
치즈케이크도 하나 주세요	네 진동벨로 알려드릴게요
아메리카노 하나 주세요	네 준비해드릴게요
케이크는 어떤 게 잘 나가나요	치즈 케이크가 잘 나갑니다
치즈케이크랑 포크 2개 주실 수 있나요	네 가능합니다
현금영수증 해주세요	네 번호 눌러주세요
혹시 테이크아웃 잔에 받을 수 있나요	그건 정책상 불가능합니다
라테 한 잔이요	네 원두 종류를 골라주세요
신맛이 없는 걸로 주세요	네 4000원입니다
적립해주세요	네 알겠습니다
초코케이크도 주세요	저희 케이크가 다 떨어졌어요
라테만 주세요	네 잠시만 기다려 주세요
카페모카 한 잔 주세요	네 드시고 가시나요?
아니요 테이크아웃 할게요	휘핑크림은 올려 드릴까요?
휘핑크림은 빼주세요	네 5600원입니다
네 현금영수증 해주세요	네 여기 핸드폰 번호 입력해주세요
네 알겠습니다	음료 나오면 불러드릴게요
주차는 가게 앞에도 해도 되나요?	네
에스프레소는 얼마인가요?	3000원입니다
토마토주스 설탕 빼고 한 잔 주세요	네
마감시간은 언제인가요?	11시입니다
사장님은 어디 가셨나요?	병원에 가셨습니다
캐러멜 프라푸치노 겨울에도 되나요?	네 됩니다
자바칩 추가하면 얼마 더 내야 돼요?	500원 추가로 내시면 됩니다
더블 샷도 추가 비용 있나요?	제휴카드 있으시면 무료입니다
치즈케이크는 어떤 종류가 있나요?	뉴욕 치즈케이크랑 블루베리 치즈케이크가 있습니다
그럼 캐러멜 프라푸치노 벤티 하나랑 블루베리 치즈케이크 하나 주세요	네 만 원입니다
에스프레소 한 잔 있어요?	어느 사이즈로 드릴까요?
크기가 어떻게 있나요?	솔로와 도피오와 트리플이 있어요
양이 제일 많은 것으로 주세요	트리플로 드리겠습니다
그리고 차가운 것으로 주세요	손님 저희 카페는 아이스 에스프레소를 하지 않습니다
그러면 아이스 아메리카노 가장 큰 사이즈로 주세요	아이스 아메리카노 점보 사이즈 한 잔 주문받았습니다
아이스 아메리카노 샷 추가 가능한가요?	샷 추가 가능합니다 그렇게 주문 도와드릴까요?
잠시만요 한 번 여쭤볼게요	네 그러세요
샷 추가 말고 기본으로 주세요 샷 추가 안 하시겠대요	알겠습니다 결제는 어떻게 하시겠어요?
이 카드로 할게요	영수증 필요하시나요?
아니요 버려주세요	진동벨 드리겠습니다 울리면 찾으러 와주세요
여기 커피 중 어떤 게 맛있나요?	아이스 아메리카노도 있고 다 맛있어요
아이스 아메리카노 한잔 주세요 아 그리고 샷 하나 추가요	무슨 사이즈로 드릴까요?
그란데요	더 필요하신 것 있으세요?
치즈케이크 하나 얼마에요?	4500원이요
그걸로 주세요	조금만 기다려 주세요
캐러멜마키아토 하나 주실래요?	지금 캐러멜이 다 떨어졌는데 다른 걸로 해주실 수 있으신가요?
그럼 그냥 아메리카노 주세요	안에서 드시나요?
아니요 테이크 아웃할게요	네 1500원 결제 도와드릴게요
카드 계산할게요	혹시 쿠폰 있으세요?
네 쿠폰 종이 4개 찍었어요	5개면 아메리카노 무료에요
카페에서 제일 많이 나가는 메뉴가 뭐예요?	아이스 아메리카노입니다
디저트 중에 제일 잘나가는 건 뭐예요?	당근 케이크입니다
세트 메뉴 있나요?	네 있습니다
그럼 세트메뉴로 하나 주세요	네 만 이천 원입니다
여기요 현금영수증 해주세요	네 번호 입력해주세요
미팅룸이 마련되어 있나요?	미팅룸은 따로 없습니다
단체가 앉을 테이블은 있나요?	창가 쪽 넓은 테이블 이용하시면 됩니다
브런치류도 있나요?	샌드위치와 파이 종류가 있는데 준비해드릴까요?
샌드위치 여섯 개 준비해주세요	네 더 필요한 건 없으신가요?
아메리카노도 여섯 잔 부탁드립니다	바로 준비해드리겠습니다
지금 영업하시나요?	네 오늘은 일찍 문 열었어요
아이스 아메리카노 하나 주세요	네 드시고 가시 나요?
아니요 가지고 갈 거예요	삼천 원입니다
영수증도 주세요	네 여기 있습니다
얼마나 걸리나요?	10분 정도 기다려 주세요
커피 주세요?	어떤 커피로 드릴까요?
아메리카노 주세요	시원한 정도를 말씀해 주시겠어요?
아이스 아메리카노요	더 필요하신 건 없으신가요?
네	결제를 도와드리겠습니다
카드로 해 주세요	포인트는 있으신가요?
라테는 어떤 종류가 있나요?	녹차 바닐라 헤이즐넛 라테가 있습니다
바닐라 라테에는 뭐가 들어가나요?	에스프레소 스팀우유 바닐라 시럽이 들어갑니다
바닐라 라테는 얼마인가요?	4천 원입니다
주문하면 얼마나 걸리나요?	10분 이내에 나옵니다
테이크아웃하면 할인되나요?	테이크아웃할 경우 오백 원 할인 적용해 드립니다
커피 메뉴 말고는 없나요?	여기 보시면 티도 있고 디저트 메뉴도 있습니다
제일 잘나가는 디저트는 어떤 건가요?	초코 케이크가 가장 유명해요
그럼 초코 케이크랑 가장 잘 어울리는 음료는 어떤 건가요?	아메리카노나 얼그레이를 보통 같이 주문하세요
그러면 얼 그레이 티 한 잔과 초코케이크 한 조각 주세요	네 현금으로 하시겠어요?
아니요 카드로 결제할게요	네 금방 준비해드리겠습니다
지금 초콜릿 프라푸치노 되나요?	네 됩니다 사이즈 어떤 걸로 드릴까요?
톨 사이즈요	크림 위에 올려드릴까요?
네 올려주세요	다른 건 필요한 거 없으신가요?
네 없어요	할인이나 적립카드 있으신가요?
네 있어요 하나카드요	전화번호 불러주세요
카페라테 한 잔이요	네 뜨거운 거요 아니면 아이스요?
아이스로 주세요	포인트 적립하시나요?
네 잠시만요	쿠폰 없으시면 핸드폰 번호 불러주셔도 됩니다
핸드폰 번호로 부르겠습니다	네 불러주세요
#전화번호#입니다	적립되셨습니다
메뉴판 보여주실 수 있나요?	네 여기 있습니다
아이스 라테 우유 말고 두유로 변경 가능한가요?	네 가능합니다
변경하면 얼마죠?	변경해서 4500원입니다
텀블러에 담아주세요	네 알겠습니다
쿠폰 찍어주세요	찍어 드렸습니다
아메리카노 한 잔 주세요	네 뜨거운 거 맞으시죠?
네 맞아요	4500원입니다
포인트 사용할 수 있나요?	네 사용 가능합니다
카드 포인트로 사용해주세요	사용하셔서 4000원 결제 도와드리겠습니다
감사합니다	좋은 하루 보내세요
라테는 얼마에요?	5500원입니다
라테 두 잔 주세요	따듯한 라테로 준비해 드릴까요?
아니요 시원한 걸로 주세요	아이스 라테 두 잔 준비해 드리겠습니다
현금 영수증 가능하죠?	앞에 키패드에 번호 입력해 주세요
매장에 사 마시고 가도 되죠?	네 그럼 유리잔에 준비해 드리겠습니다
아이스 아메리카노 샷 몇 개 들어가나요?	고객님 아이스 아메리카노는 샷 두 개 들어가요
샷 추가 시 얼마인가요?	500원입니다
아이스 아메리카노 샷 추가 하나랑 아이스 초코 라테 한 잔 주세요	초코 라테 위에 휘핑크림 올려드릴까요?
휘핑크림 빼주세요	네 알겠습니다
먹고 갈게요	네 그럼 머그잔으로 준비해드리겠습니다
아이스 아메리카도 디카페인 가능한가요?	네 가능합니다
잠시 앉아있다 바로 나갈 건데 테이크아웃으로 해주실 수 있나요?	나가실 때 테이크아웃에 담아드리겠습니다
할인되는 카드도 있나요?	네 있습니다 포인트 적립도 가능합니다
충천을 하고 싶은데 가능한가요?	저희는 따로 해드리지는 않고 의자 근처에 콘센트는 있습니다
산미가 많이 들어간 커피는 뭐가 있을까요?	에티오피아 커피가 있습니다
혹시 배달되나요?	걸어서 5분 내에 있으면 배달해드리고 있습니다
많이 주문할 건데 괜찮을까요?	몇 잔 주문하실 건가요?
아이스커피 6잔이랑 자몽에이드 6잔 그리고 머핀 12개요	제가 혼자 운영하다 보니 그렇게 많은 양은 배달해 드리기 어렵습니다
그러면 5시에 가져갈 수 있도록 준비해주실 수는 있나요?	네 5시까지 포장은 다 해드릴 수 있습니다
그럼 이따 5시에 다시 오면 될까요?	네 미리 준비해 놓도록 하겠습니다
아이스 카페라테 한 잔이요	4500원입니다
텀블러에 담아 갈게요	네 알겠습니다
텀블러 이용 시 할인 얼마나 되죠	300원 할인해 드립니다
카드로 계산할게요	네 카드 받았습니다
지금까지 적립금 알 수 있을까요	적립금 1000원 쌓여있습니다
카푸치노 아이스로 되나요?	가능합니다
어린이가 먹을 수 있는 음료 있나요?	과일주스나 우유가 들어간 초코 음료 추천드릴게요
빵이나 샌드위치 메뉴가 있나요?	베이글 샌드위치와 머핀이 있습니다
흡연할 수 있는 공간이 있나요?	카페 옆에 흡연장소가 마련되어 있습니다
카푸치노는 이 쿠폰으로 계산해도 되나요?	네 이거로 결제해드릴게요
아이스 아메리카노 레귤러 사이즈 얼마인가요?	1800원입니다
얼음은 갈아서 넣어주실 수 있나요?	네 그렇게 해드리게요
포인트카드 적립되나요?	네 됩니다
카드로 계산할게요	네 계산 완료했습니다
시럽은 어디에 있나요?	왼쪽 판매대 쪽에 있습니다
아메리카노 한잔 주세요	사이즈는 어떤 걸로 드릴까요?
작은 사이즈로 부탁드려요	필요한 디저트류는 없으신가요?
여기 이 쿠키는 단맛이 강한가요?	버터 쿠키보다 초코 쿠키가 단맛이 조금 덜합니다
그럼 초코 쿠키도 1봉지 부탁드려요	아메리카노 한 잔과 초코 쿠키 한 봉지 가격은 4500원입니다
여기 기프트 카드로 결제 부탁해요	네 결제 완료되었습니다
아메리카노 4000원 하나 주문하겠습니다	네 아이스랑 핫 중 어느 것으로 드릴까요?
아이스로 부탁합니다	네 아이스는 500원 추가됩니다
사이즈는 라지로 부탁드리겠습니다	라지는 기본에 500원 추가가 됩니다
그럼 계산 부탁드리겠습니다	네 5000원 계산 도와드리겠습니다
혹시 쿠폰 할인도 가능한가요?	네 쿠폰 할인으로 2000원 결제 도와드리겠습니다
아이스 아메리카노 하나 주세요	사이즈는 어떤 걸로 드릴까요?
사이즈 종류 좀 말해주세요	톨 그란데 벤티 사이즈 있습니다
그란데로 부탁드려요	진동벨 가져가셔서 준비 다 되면 울려드리겠습니다
얼마나 걸릴까요?	5분 정도 걸릴 거 같아요
주차 증도 주세요	음료 드릴 때같이 드릴게요
스무디 종류 있나요?	네 3가지 있습니다
딸기맛은 얼마죠?	4500원입니다
그리고 휘핑해주세요	휘핑 종류 선택해주세요
저지방 휘핑으로 해주세요	저지방 휘핑 올린 딸기 스무디 나왔습니다
아 그리고 오늘 영업은 몇 시까지 하나요?	오늘 영업은 10시까지 합니다
지금 플랫 화이트 되나요?	우유가 지금 떨어져서 어렵습니다
그러면 아메리카노는 되나요?	네 가능합니다
원두는 브라질산인가요?	아니요 페루산입니다
조금 더 쓴맛이 나는 것은 없나요?	오늘 준비된 원두는 페루산만 있습니다
그러면 아메리카노 라지 사이즈 하나 주세요	네 아이스로 준비해드릴게요
아메리카노 하나 주세요	사이즈는 어떤 걸로 드릴까요?
라지 사이즈로 주세요	드시고 가세요?
아니요 포장해주세요	스탬프 쿠폰 만들어드릴까요?
네 만들어주세요	다른 건 필요 없으세요?
생크림 케이크는 얼마인가요?	8천 원입니다
음료가 언제 나오나요?	곧 준비해드리겠습니다
쿠폰 몇 장 모아야 한잔 무료인가요?	10장 모으시면 한잔 무료입니다
몇 시부터 마감하시죠?	밤 11시부터 마감이에요
콘센트가 있는 자리는 어디입니까?	카운터 맞은편 자리에 콘센트 가까이 준비되어 있습니다
아이스 아메리카노 3잔에 얼마에요?	13500원입니다
주문 가능한가요?	네 가능합니다
아메리카노 한 잔에 얼마죠?	3000원입니다
아이스도 똑같은가요?	네 똑같습니다
샷 추가 가능한가요?	한 샷 당 500원 추가됩니다
아이스 아메리카노 한 잔에 샷 추가해주시고 현금영수증도 부탁드립니다	네 번호 입력해주세요
미숫가루 되나요?	네 3월부터 개시하였습니다
사이즈업하면 얼마죠?	500원 추가되어 4500원입니다
그럼 미숫가루 사이즈업 2잔 주문할게요	드시고 가시나요?
테이크아웃 할 거예요	트레이에 담아드리겠습니다
치즈케이크 한 조각도 추가할게요	4000원 추가되어 총 13000원 결제 도와드리겠습니다
자바칩 프라푸치노 주세요	무슨 사이즈로 드릴까요?
어떤 사이즈가 있나요?	톨 그란데 벤티 사이즈가 있습니다
그란데 사이즈로 부탁드립니다	할인카드나 멤버십 카드 있으신가요?
네 있습니다	적립해드렸습니다
음료는 언제 나오나요?	5분 안에 주문번호로 불러드리겠습니다
기프티콘 사용은 어떻게 하면 되나요?	기프티콘 금액만큼 현금으로 사용하실 수 있습니다
그럼 아이스 아메리카노랑 치즈케이크 주세요	그렇게 하실 경우 가격이 초과되어 추가요금 내셔야 합니다
추가요금 얼마나 내면 되나요?	지금 기프티콘 가격이 5100원이니 해당 금액 제외하고 2500원 추가요금 결제하시면 됩니다
카드로 결제할게요	앞에 보이시는 카드 단말기에 카드 꽂아주시기 바랍니다
쿠폰 적립되나요?	쿠폰 적립해드릴게요
행사 중인 메뉴 있나요?	아침에 샌드위치 구매하시면 아메리카노 천원 할인해드려요
아메리카노 아이스로 가능한가요?	아이스는 500원 추가됩니다
커피 대신 추가 금액 내면 다른 음료도 가능한가요?	음료는 아메리카노만 가능해요
샌드위치 따뜻하게 가능한가요?	전자레인지에 데워드릴게요
카카오 파이로 결제 가능한가요?	휴대폰 주시면 결제 도와드릴게요
여기 대표 메뉴가 무엇인가요?	토피넛라떼입니다
토피넛라떼에도 커피가 들어가나요?	네 들어갑니다
커피는 몇 샷 들어가나요?	기본적으로 커피는 투 샷 들어갑니다
혹시 커피를 좀 연하게 타주실 수 있나요?	네 가능합니다
가격은 얼마인가요?	4800원입니다
아메리카노 한 잔 주세요	따뜻한 걸로 드릴까요?
네 대신 얼음 두 조각만 넣어주세요	네 4000원입니다
케이크는 뭐가 맛있나요?	요즘 초코케이크가 잘 나가고 있습니다
많이 달지 않나요?	많이 달지 않습니다
초코케이크도 같이 주세요	네 9000원입니다
아이스 아메리카노 한 잔 샷 추가해서 주세요	샷을 추가하면 500원 추가되는데 괜찮으시겠어요?
네 추가해주세요	샷을 한 번 내리는데 두 샷이 나오는데 두 개 다 넣어드릴까요?
네 그렇게 해주세요	드시고 가시면 머그잔에 드리는 것 괜찮으신가요?
아 저 갖고 갈 거라 테이크아웃잔에 주세요	5000원 결제해드리겠습니다
카카오 파이로 결제할게요	네 커피 여기 있습니다
혹시 찬물이 따로 있나요?	저쪽 벽에 있습니다
물이 다 떨어졌는데요?	다시 채워드리겠습니다
얼음도 넣어주세요	네 얼음도 넣어드릴게요
주문해도 될까요?	네 어떤 거로 드릴까요?
토피넛 라테 따뜻하게 하나요	4천500원입니다
아메리카노 하나 주세요	레귤러 라지 맥스 사이즈 있습니다
라지로 주세요	따뜻한 것과 차가운 것 어떤 것으로 하시겠어요?
따뜻한 아메리카노요	4100원입니다
4100원이면 맥스 사이즈로 주세요	4800원입니다
5000원 드릴게요 거슬러 주세요	현금영수증 하시겠어요?
블랙 티 되나요?	얼그레이와 잉글리시 브렉퍼스트가 있는데 어떤 걸로 하시겠어요?
얼그레이로 부탁드려요	따뜻한 걸로 드릴까요?
네 따뜻한 걸로 주세요	드시고 가시면 머그컵에 준비해드려도 괜찮을까요?
네 그렇게 해주세요	뭐 더 주문하실 건 없으신가요?
베이글도 하나 데워주세요	네 9000원입니다
바닐라 라테 주세요	사이즈는 어떤 걸로 하시겠어요?
그란데 사이즈로 부탁드릴게요	통신사 할인하시나요?
네 잠시만요 핸드폰 좀 꺼내겠습니다	통신사 할인되셨는데 포인트도 적립하시겠어요?
네 포인트 적립하겠습니다	앞에 번호 찍어주세요
혹시 음료는 몇 분 뒤에 나오나요?	2분 안에 나올 예정입니다
아메리카노 한 잔 주시겠어요?	따뜻한 것과 아이스 중 어떤 걸로 드릴까요?
아이스로 주세요	사이즈는 톨 괜찮으세요?
톨 제일 작은 사이즈인가요?	네 톨 그란데 벤티 사이즈가 있습니다
그란데 사이즈로 주세요	드시고 가시나요?
네 개인 텀블러에 부탁드립니다	잠시만 기다려주세요
주문 가능한가요?	네 잠시만 기다려주세요
아인슈페너는 무엇인가요?	비엔나커피 같은 것입니다
아이스도 될까요?	네 가능합니다
케이크도 함께 주문 가능한가요?	네 가능합니다
초코 쇼콜라티에 블랙베리 무스 케이크는 뭔가요?	초코무스와 블랙베리 무스로 이루어진 케이크입니다 맛있습니다
자바칩 프라푸치노 한 잔 주시겠어요?	5500원입니다
kt 멤버십 있으면 사이즈업 가능한가요?	가능합니다
휘핑 추가도 할게요	추가요금 500원을 받는데 괜찮으세요?
네 추가할게요	총 6000원 결제 도와드리겠습니다
멤버십 적립도 같이 할게요	바코드 보여주시면 도와드리겠습니다
에스프레소 가능한가요?	네 고객님
여기 원두는 어떤 걸 쓰나요?	지금 예가체프 원두 사용하고 있어요
와이파이 사용 가능한가요?	네 비밀번호는 영수증 아래에 적혀있습니다
화장실이 어디죠?	밖으로 나가서 왼쪽에 있습니다
그럼 에스프레소 한 잔 부탁드립니다	쿠폰 찍어드릴까요?
원두 선택할 수 있나요?	3가지 종류 중에 고르실 수 있으십니다
아이스 아메리카노 기본 몇 샷 들어가나요?	투 샷 들어가는데 원하시면 추가 제거 가능하십니다
아이스 아메리카노와 따뜻한 아메리카노 가격 차이 있나요?	아니요 아메리카노는 아이스여도 추가 금액 받지 않습니다
한 잔에 얼마인가요?	이천오백 원입니다
8잔 지금 가능한가요?	아메리카노는 금방 나오기 때문에 10분 정도 기다려 주시면 됩니다
아이스 아메리카노 작은 걸로 하나 주세요	다른 건 필요한 거 없으신가요?
아 쿠키도 하나 같이 계산해주세요	어떤 쿠키로 드릴까요?
오트밀 쿠키로 주세요	오트밀 쿠키 하나 아이스 아메리카노 한잔 맞으시죠?
네 얼마인가요?	다 합해서 3500원입니다
카드로 계산할게요	네 카드 받았습니다
카페라테 샷 추가되나요?	가능합니다
기본 투 샷인가요?	네
카페라테 샷 추가해서 주세요	드시고 가시나요?
테이크아웃입니다	포인트 있으세요?
그냥 결제해주세요	4000원 결제해드리겠습니다
아포가토 주문 가능한가요?	지금 아이스크림이 없어 주문 불가합니다
그럼 아메리카노 하나 주세요	네 알겠습니다
통신사 카드 할인되나요?	네  KT 사용하시면 가능합니다
할인 부탁드립니다	네 할인되었습니다
자리에서 기다리면 되나요?	음료가 나오면 불러드리겠습니다
티 주세요	어떤 티로 드릴까요?
허브티 어떤 게 있어요?	캐머마일 그리고 페퍼민트 있어요
캐머마일 주세요	따뜻한 걸로 드릴까요?
차가운 걸로 주세요	금방 준비해 드릴게요
얼마에요?	4500원입니다
라테 한 잔 얼마에요?	5000원입니다
라테 한 잔에 샷이 몇 개 들어가나요?	샷은 2개 들어갑니다
라테 위에 바닐라 아이스크림 올리면 얼마 추가되나요?	2500원 추가됩니다
케이크는 뭐가 제일 잘나가요?	딸기 철이라 딸기 케이크가 제일 잘나갑니다
제 텀블러 사용하면 텀블러 할인되죠?	네 당연하죠
아메리카노 주세요	뜨거운 걸로 드릴까요?
아니요 아이스로요	네 4000원입니다
기본 2샷인가요?	아니오 1샷이요
그럼 샷 추가해주세요	500원 추가됩니다
여기요	감사합니다 주문번호로 불러드릴게요
아메리카노 하나요	아이스인가요?
아뇨 핫으로요	네 드시고 가세요?
테이크아웃이요	결제 도와드릴게요
카드 여기요	영수증 필요하세요?
네 감사해요	영수증 여기요
아이스 음료도 사이즈업 가능한가요?	어떤 음료 말씀하시는 건가요?
화이트초콜릿 모카 아이스요	그 음료는 사이즈 업은 안됩니다
그럼 그냥 보통 사이즈 주시고 거기에 얼음 좀 많이 해서 주세요	고객님 화이트 초콜릿 모카 아이스로 얼음 많이 맞으신가요?
맞습니다	가격은 3500원입니다
포인트 적립해주세요	적립해드렸습니다
아메리카노 한 잔 주세요	따뜻한 아메리카노로 드릴까요?
아니요 아이스로 주세요	네 4500원입니다
샷 추가는 얼마인가요?	샷 추가는 500원입니다
그럼 샷 추가해주세요	네 더 필요한 건 없으세요?
없습니다	진동벨 받고 잠시만 기다려 주세요
바닐라 라테 주문 가능한가요?	네 가능합니다
그럼 바닐라 라테랑 블루베리 크림 와플 하나 주세요	바닐라 라테에 휘핑 올려드릴까요?
네 올려주세요	네 와플은 잘라드릴까요?
반으로 잘라주세요	네 9천 원 결제 도와드리겠습니다
네 현금영수증 해주세요	네 불러드릴 테니 앉아계세요
아메리카노 샷 추가해서 주세요	따뜻하게 드릴까요?
아이스 아메리카노로 주세요	그럼 아이스 아메리카노 하나 주문 도와드리겠습니다
얼마예요?	샷 추가하셔서 4000원입니다
카드 결제할게요	네 결제 도와드리겠습니다
쿠폰도 찍어주세요	네 찍어드리겠습니다
아이스 아메리카노 두 잔 주세요	7000원입니다
할인되는 카드나 적립 카드 있나요?	유플러스 멤버십 있으시면 사이즈 업 돼요
그럼 하나는 사이즈 업해주세요	그리고 국민카드 하시면 지금 적립 두배 됩니다
국민카드는 없네요	네 그럼 유플러스 바코드 주시면 한잔 사이즈 업해드릴게요
여기 있습니다	네 진동벨이 울리면 가지러 와주세요
초코 라테 되나요?	네 따뜻하게 차갑게 모두 가능하세요
아이가 마실 거라 얼음은 반만 넣어 주세요	그러면 양이 적어 보일 수 있는데 괜찮으세요
아이는 조금 먹으니까 괜찮아요	드시고 가시나요?
가지고 갈 거예요	진동벨로 알려드릴 테니 조금만 기다려 주세요
저 화장실에 잠시 다녀올 테니 한쪽에 놔주세요	네 알겠습니다
오늘의 커피는 어떤 건가요?	오늘의 커피는 과테말라입니다
숏 되나요	네 5분 정도 걸리는데 괜찮은가요?
기다리겠습니다	잠시 후 번호를 부르겠습니다
저기 있는 아이스크림은 뭐지요?	시식할 수 있습니다
일행이 있는데 2개 가져가도 되나요?	네 가져가셔도 됩니다
아이스 아메리카노 한 잔 얼만가요?	3000원입니다
사이즈 업 가능한가요?	네 가능하십니다
얼음은 각 얼음이랑 갈린 얼음 중에 고를 수 있나요?	네 고르실 수 있습니다
샷 추가도 추가 비용 발생하죠?	네 500원 추가 비용 있으십니다
네 현금영수증 해주세요	번호 눌러주세요
딸기 셔벗 되나요?	아니요 계절 메뉴라 지금은 불가능해요
그럼 주문 가능한 셔벗이 있을까요?	셔벗은 모두 불가능합니다
그럼 팥빙수도 불가능한가요?	아니요 팥빙수 주문 가능하세요
빙수에 얼음은 조금만 넣어주실 수 있나요?	가능한데 양이 적을 수 있어요
얼음은 기존보다 조금만 적게 주시겠어요?	네 얼음 적게 팥빙수 주문받았습니다
아메리카노 하나요	따뜻한 거 드릴까요?
네 따뜻한 걸로 주세요	사이즈는 어떤 걸로 드릴까요?
제일 작은 사이즈로 주세요	적립은 해드릴까요?
네 해주세요	번호 눌러주시기 바랍니다
네 눌렀습니다	음료 나오면 진동벨로 알려드릴게요
인기 있는 메뉴가 무엇인가요?	런치세트로 샌드위치와 아메리카노가 잘 나갑니다
그걸로 주시고 카드 가능하죠?	네 가능합니다
통신사 멤버십 할인 가능한가요?	여기 쓰여있는 곳만 가능합니다
그럼 멤버십 할인해주세요	알겠습니다
도장 쿠폰은 없어졌나요?	네 이번 달부터 없어졌습니다
아메리카노 디카페인 있나요?	디카페인은 없고 1/2카페인은 있습니다
가격은 얼마인가요?	4100원입니다
카카오페이 되나요?	카카오페이는 내일부터 가능할 예정입니다
그럼 그냥 현금으로 할게요	현금영수증 해드릴까요?
네 해주세요	휴대폰 번호 찍어주세요
아메리카노 한 잔 주세요	따뜻한 것으로 드릴까요?
음료에 시럽 빼주실 수 있나요?	네 빼드릴게요
사이즈 업 가능한가요?	미디엄과 라지 중 골라주세요
음료에 이물질이 들어가 있어요	다시 만들어드릴게요
몇 시까지 영업하나요?	열시에 문 닫아요
인기 있는 메뉴가 뭔가요?	네 밀크티 라테가 인기가 좋아요
단맛이 강한 편인가요?	원하시면 당도를 조절해 드려요
그럼 많이 달지 않게 부탁드릴게요	네 아이스로 드릴까요?
아니요 따뜻하게 부탁드릴게요	결제 도와드리겠습니다
혹시 카페 쿠폰 주시나요?	네 도장 찍어드립니다
아이스 아메리카노 1잔 딸기 스무디 1잔 주세요	지금 딸기가 다 떨어져서 딸기 스무디가 안 될 것 같습니다
그럼 아이스 아메리카노 2잔 주세요	적립 도장 찍으시나요?
여기 있습니다	도장 10개 있으셔서 한 잔은 무료로 드리겠습니다
감사합니다	드시고 가십니까?
아니요 가지고 갑니다	테크 아웃 잔에 담아 드리겠습니다
이 카페는 몇 시까지 영업하나요?	10시까지 영업합니다
그럼 아직 주문 가능한가요?	네 가능합니다
그럼 아메리카노 한 잔하고 핫 샌드위치 한 개 주세요	네 샌드위치는 10분 정도 걸릴 수 있는데 괜찮으신가요?
네 괜찮습니다	네
커피 먼저 받을 수 있을까요	네 그럼 커피 먼저 드리고 샌드위치는 진동벨로 따로 알려드리겠습니다
아이스 아메리카노 두 잔이랑 치즈케이크 할게요	죄송한데 치즈 케이크가 다 떨어졌어요
이 쿠폰 결제하려고 하는데 그러면 결제가 안 되나요?	아니요 케이크를 다른 케이크로 고르 실 수 있어요
아무거나 다 되나요?	네 치즈 케이크보다 비쌀 경우 차액만큼 주시면 됩니다
더 싸면요?	그 경우 저희가 잔액을 거슬러 드립니다
당근 케이크 할게요	그러면 저희가 200원 거슬러 드릴게요
주문해도 될까요?	네 음료 고르셨어요?
카페라테 주세요	따뜻한 걸로 드릴까요?
아이스로 주세요	휘핑크림 올려드릴까요?
네 많이 올려주세요	다른 건 필요한 거 없으세요?
디카페인 원두로 주문 가능할까요?	네 가능합니다
카페라테 한잔 주세요	사이즈는 어떻게 해 드릴까요?
어떤 사이즈가 있나요?	미디엄과 라지가 있습니다
라지 사이즈로 주세요	더 필요하신 건 없으신가요?
치즈케이크 한 조각도 추가해 주세요	총 8000원입니다
현금 영수증 가능하죠?	네 물론이죠
카페모카 프라푸치노 있나요?	프라푸치노는 없고 비슷한 음료인 아이스 카페모카는 있어요
그럼 아이스 카페모카 얼음 많이 넣어서 주세요	네 더 필요하신 건 없나요?
베이글은 어떤 종류가 있나요?	블루베리 베이글이랑 크림치즈 베이글 두 가지 있어요
블루베리 베이글 데워 주실 수 있나요?	네 데워 드릴게요
음료는 나가서 마실 거라 플라스틱 용기에 주세요	네 아이스 카페모카 한 잔 블루베리 베이글 결제 도와드릴게요
망고 주스 되나요?	네 준비해드릴까요?
얼음은 빼 주세요	네 알겠습니다
가격이 얼마에요?	6천 원입니다
카드 결제되나요?	네 가능합니다
영수증 주세요	영수증 드리겠습니다
여기 혹시 아침세트 메뉴 있나요?	네 아메리카노 세트 있어요
그럼 지금 5세트 주문할게요	네 더 필요한 건 없으세요?
빵 종류가 세트 말고도 있으면 같이 주세요	얼마나 드릴까요?
한 5개 정도 넣어주세요	네 조금만 기다리세요
네 다 포장해서 주세요	네 알겠습니다
아이스 모카 한잔 주세요	드시고 가시나요?
아니요 테이크아웃할게요	휘핑크림 올려드릴까요?
네 많이 주세요	다른 건 필요하신 거 없으세요?
애플파이 하나도 같이 포장해주세요	아이스 모카랑 애플파이 해서 9500원 나왔습니다
포인트 적립해주세요	네 포인트 적립하고 결제해드리겠습니다
아메리카노 한잔 얼마인가요?	4천 원입니다
아메리카노 한잔 주세요	아이스로 드릴까요 뜨거운 걸로 드릴까요?
아이스로 부탁드려요	네 잠시만 기다려주세요
제휴카드로 할인 가능한가요	네 가능합니다
네 그럼 할인 적용해주세요	네 알겠습니다
아이스 아메리카노 한 잔이요	톨 사이즈로 드리면 될까요 고객님?
네 매장에서 마시고 갈게요	그럼 머그컵에 준비해드리겠습니다
카카오 파이로 계산할게요	네 따로 적립카드는 없으신가요?
네 없습니다	영수증 여기 있습니다
그냥 버려주세요	알겠습니다
아메리카노 따뜻한 걸로 주세요	네 알겠습니다
샷 추가되나요?	샷 500원인데 추가할까요?
네 추가해 주세요	더 필요한 거 있으세요?
화장실 비밀번호가 어떻게 돼요?	****입니다
따뜻한 물 한잔 주세요	잠시만 기다려 주세요
돌체 라테 하나 주세요	아이스로 드릴까요?
네 그리고 두유로 바꿔주세요	네 사이즈는 어떤 걸로 해드릴까요?
톨 사이즈로 해주세요	다른 거 더 필요한 건 없으신가요?
네 없어요	적립이나 할인되시는 카드 있으신가요?
네 여기요	적립되셨고요 5600원입니다
겨울인데 빙수 주문 가능할까요?	겨울 시즌에는 빙수는 잠시 동안 팔지 않습니다
아 그럼 겨울에만 판매되는 메뉴는 있나요?	네 겨울에는 집에서 직접 담근 과일청 차 팔고 있어요
그럼 과일청 차 2개만 추천 부탁드릴게요	가장 잘 나가는 건 영귤차랑 자몽차가 있습니다
혹시 차류도 시원하게 되나요?	네 따뜻하게 시원하게 모두 됩니다
그럼 영귤차 하나 자몽차 하나씩 테이크아웃할게요	네 만 원 받았습니다 현금영수증 하시겠어요?
주문해도 되죠	주문하세요
메뉴판에 있는 것 모두 주문 가능한가요?	모두 가능합니다
딸기 라테 주세요	사이즈는 어떻게 하시겠어요?
라지로 따뜻한 음료 가능한가요?	물론입니다
그럼 그렇게 해주세요	6천 원입니다
새로운 음료가 출시되었다고 들었는데요	네 진한 초콜릿 음료가 이번에 새로 나왔습니다
다른 사람들의 평이 어떤가요?	요즘 맛있다고 소문이 나서 주문이 많아요
아 그러면 새로운 메뉴로 2잔 부탁드려요	네 알겠습니다
혹시 음료 말고 다른 디저트 제공도 되나요?	네 원하시는 디저트 말씀해주세요
당근 케이크로 부탁드릴게요	그렇게 준비하도록 하겠습니다
아메리카노 주문 가능한가요?	네 주문 가능합니다
뜨겁지 않게 해주실 수 있나요?	그럼요 가능합니다
여기 밀크티는 얼마에요?	5500원입니다
그럼 밀크티도 한잔 주세요	네 알겠습니다
현금영수증 해주세요	네 번호 불러주세요
카페라테 가격이 얼마에요?	따뜻한 거 말씀하신 건가요?
네	4500원입니다
아이스 캐러멜 마키아토는요?	4800 원입니다
아이스 캐러멜 마키아토 하나 주세요	결제 카드로 해드릴까요?
네	포인트 적립하시나요?
메뉴판에 없는 것도 주문 가능할까요?	아니요 고객님 메뉴판에 있는 것만 주문 가능합니다
그러면 캐러멜 라테 한 잔 주세요	사이즈는 어떤 사이즈로 드릴까요?
사이즈 별로 가격이 어떻게 되나요?	레귤러 사이즈는 4800원 라지 사이즈는 5300원입니다
그럼 라지 사이즈로 주세요	네 고객님 테이크아웃 하시나요?
아니요 마시고 갈 거예요	네 그럼 머그잔에 준비해 드리겠습니다
혹시 메뉴판 주실 수 있나요?	네 여기 있습니다
혹시 커피 안 들어간 메뉴 있나요?	네 메뉴판 잠깐 보여주시겠어요?
아 여기 있네요	네 맞습니다
그럼 녹차라테 하나 주세요	차가운 걸로 드릴까요?
아니요 뜨거운 걸로 주세요	네 알겠습니다
당근 케이크 지금 남아있나요?	네 남아 있습니다
아이스 카페라테 한 잔이랑 당근 케이크 하나 주세요	네 더 필요하신 것은 없으신가요?
포인트 적립 가능한가요?	네 가능합니다
삼성 파이로 결제 가능하죠?	네 결제 도와드릴게요
당근 케이크는 따로 결제할 수 있나요?	네 그렇게 도와드리겠습니다
레귤러 사이즈 아메리카노와 베이글 하나 주세요	어떤 커피로 드릴까요?
어디서 온 커피가 있나요?	콜롬비아와 에티오피아 중 선택하실 수 있습니다
그럼 콜롬비아 하나 주세요	네 데워드릴까요?
무엇을요?	베이글을 데워드릴까요?
네 데워주세요	따뜻한 레귤러 아메리카노와 베이글 하시면 7000원입니다
여기는 커피만 파나요?	주스나 차 종류도 있습니다
차 종류는 어떤 게 있나요?	블랙 티와 유자차 그리고 레몬티가 있어요
레몬티는 단 음료인가요?	레몬 청으로 만드는 거라 조금 달아요
그럼 아이스로는 되나요?	네
아이스 레몬 티로 세 잔 포장해주세요	네 8400원입니다
블루베리 치즈케이크 주세요	네 드시고 가시나요?
아니요 포장해주세요	초는 몇 개 드릴까요?
27개 주세요	적립 필요하신가요?
아니요 현금영수증 해주세요	네 번호 입력해주세요
쿠폰도 찍어주세요	죄송하지만 쿠폰은 따로 없습니다
라테 아이스로 주세요	시럽 넣어드릴까요?
3번 펌핑해주세요	다른 건 안 필요하시나요?
케이크는 어떤 종류가 있나요?	진열대에 보시면 초코케이크 치즈케이크 당근 케이크가 있습니다
당근 케이크 얼마에요?	4500원입니다
커피랑 같이 주세요	진동벨 울리면 받으러 와주세요
달콤한 커피는 어떤 종류가 있죠?	캐러멜 마키아토와 카페 모카 바닐라 라테가 있습니다
캐러멜 마키아토로 주세요	따뜻한 음료 맞으세요?
네 맞습니다	휘핑크림 얹어 드릴까요?
아니요 빼주세요	드시고 가시나요?
테이크아웃으로 부탁드립니다	주문하신 음료 나왔습니다
아이스 아메리카노 하나 주세요	죄송하지만 지금 원두가 떨어져서 아메리카노는 어려울 것 같습니다
그러면 자몽 주스 하나로 부탁드릴게요	자몽 주스 사이즈는 어떻게 드릴까요?
라지 사이즈로 주세요	더 필요한 거 있으신가요?
클럽 샌드위치도 하나 주세요	총 8500원입니다
여기 카드요	카드 받았습니다
아이스 아메리카노 한 잔에 얼마인가요?	삼천 원입니다
블루베리 머핀은 얼마인가요?	이천 원입니다
아이스 아메리카노랑 블루베리 머핀 주세요	네 알겠습니다
시럽은 어느 쪽에 있나요?	오른쪽으로 보시면 있습니다
머핀 데워주실 수 있으세요?	네 데워드릴게요
텀블러 구입하려고 하는데 기프티콘으로도 결제가 가능한가요?	네 가능합니다
아이스 카페모카 한 잔에 얼마예요?	5100원입니다
포인트 적립이 2배인 케이크는 어떤 건가요?	딸기 녹차 크레이프 케이크입니다
기프티콘으로 결제하고 나머지 차액은 이 카드로 결제해주세요	네 카드 보여주세요
가지고 갈 거니까 커피랑 케이크는 포장해주세요	네 진동벨로 알려드리겠습니다
아메리카노 있나요?	네 있습니다
머핀은 얼마인가요?	4000원입니다
세트 구성은 없나요?	네 없습니다
아이스 아메리카노랑 머핀 포장되나요?	네 가능합니다
포장해주세요	네
지금 주문 변경 가능한가요?	네
아이스 아메리카노에서 따뜻한 아메리카노로 바꿔주실 수 있나요?	네
혹시 테이크아웃 말고 머그잔으로 바꿔주실 수 있나요?	네 그럼 머그잔으로 해드리겠습니다
사이즈 변경도 가능한가요?	네 말씀 해주세요
제일 큰 사이즈로 바꿔주세요	네 알겠습니다
카페모카 한잔 주세요	생크림 올려 드릴까요?
조금만 올려주세요	네 다른 건 필요한 거 없으세요?
조각 케이크도 있나요?	네 생크림과  티라미슈 케이크가 있어요
생크림 케이크 한 조각도 같이 주세요	드시고 가실 건가요?
네	결제해 드리겠습니다
조각 케이크 포장되나요?	네 고객님 포장 가능하십니다
그럼 판 케이크 구매 후 조각 케이크로 포장도 가능한가요?	네 고객님 가능하시지만 시간이 조금 걸릴 수 있습니다
네 괜찮습니다 스트로베리 판케잌 6조각으로 해서 개별 포장 부탁드립니다	네 잠시만 기다려주세요
포장되었나요?	고객님 포장 다 되었습니다 많이 흔들 시 케이크가 망가질 수 있습니다 주의 부탁드립니다
얼마인가요	총 합해서 34500원입니다
카페라테 우유 종류변경 가능한가요?	네 가능하십니다
선택 가능한 우유 종류는 어떻게 되나요?	일반우유 저지방 우유 두유 세 가지 중 선택 가능합니다
변경 시 추가 비용은 발생하지 않나요	네 추가 비용 발생하지 않습니다
두유로 아이스 카페라테 한잔 부탁드립니다	네 사이즈는 레귤러 사이즈로 하시고 시럽은 필요 없으신가요?
네 레귤러 사이즈로 해주시고 시럽은 빼주세요	네 감사합니다
콜드브루 라테 되나요?	콜드브루 라테 5000원입니다
휘핑크림 올려주실 수 있나요?	네 올려드리겠습니다
혹시 컵 두개로 나눠서 담아주실 수 있나요?	네 가능하십니다
휘핑크림은 추가 금액 붙나요?	휘핑크림은 추가 금액 500원 받고 있습니다
사이즈는 뭐 있나요?	스몰 미디엄 라지 있습니다
차 요 앞에 대 놔둬 되죠?	네 가능합니다
아이스 아메리카노 하나 주시겠어요?	사이즈는 어떻게 드릴까요?
사이즈 제일 작은 게 뭐죠?	tall 사이즈입니다
그걸로 주시고 결제는 현금으로 해주시고 현금영수증 되죠?	번호 찍어주시겠어요?
어디에 눌러야 되죠?	앞에 보이시는 숫자 버튼에 번호 누르시면 됩니다
캐러멜 프라푸치노 얼마예요?	6300원입니다
샌드위치는 뭐가 제일 맛있나요?	튜너 샌드위치 추천드립니다
튜너 샌드위치도 2개 주세요	더 필요하신 것은 없으신가요?
마카롱 네 개 포함해서 같이 주세요	전부 합해서 25000원입니다
이 카드로 계산하고 영수증 주세요	알겠습니다
아이스 아메리카노 주세요	톨 사이즈 면 되나요?
아니요 사이즈 업 부탁드려요	네 고객님
통신사 할인받을게요	바코드 보여주세요
치즈 조각 케이크 있나요?	네 있습니다
얼마인가요?	3500원입니다
아이스 아메리카노 가격이 얼마인가요?	사이즈 별로 다른데 무슨 사이즈로 드시나요?
저는 톨 사이즈로 먹습니다	톨 사이즈 아메리카노는 4500원입니다
샷 추가하려면 얼마를 내야 하나요?	샷 추가마다 500원 추가해야 합니다
그럼 아이스 아메리카노 샷 추가해서 주세요	드시고 가시나요?
아니요 테이크아웃하겠습니다	잠시만 기다려주시면 금방 드리겠습니다
캐러멜마키아토 한 잔이랑 에스프레소 한 잔이요	캐러멜마키아토 한 잔이랑 에스프레소 한잔 주문 도와드릴게요
네 부탁합니다	7500원입니다
현금 계산이요	현금 계산서 해드릴까요?
네 해주세요	번호 입력 부탁합니다
네 알겠습니다	잠시만 기다려주세요
지금 커피 주문 가능한가요?	네 주문 말씀해주세요
아메리카노 한 잔이요	네 아메리카노 한 잔이요
샷 하나 추가에 얼마에요?	샷 추가 오백 원입니다
투 샷으로 해주세요	네 음료는 차게 해드릴까요?
네 그렇게 해주세요	네 아메리카노 아이스 투 샷 주문되셨습니다
아이스 아메리카노 한 잔이요	사이즈는 어떤 걸로 준비해드릴까요?
가장 작은 사이즈 주세요	그럼 스몰 사이즈로 준비해드릴게요
샷은 몇 개 들어가나요?	제일 작은 사이즈는 샷 한 개만 들어가요
톨 사이즈는 샷이 몇 개 들어가나요?	톨은 샷 두 개 들어가세요~
그럼 톨로 주세요	네 결제 도와드릴게요
아메리카노 한 잔 얼마에요?	4000원입니다
사이즈업 되나요?	네 됩니다
케이크는 뭐가 제일 맛있나요?	당근 케이크가 제일 잘나가요
당근 케이크 한 조각 주세요	네 더 필요하신 건 없으세요?
현금 영수증 해주세요	네 번호 찍어주세요
아이스 라테 하나 주세요	네 드시고 가시는 건가요?
아뇨 테이크아웃이요	네 혹시 쿠폰 있으신가요?
아뇨 만들어주세요	핸드폰 뒷자리가 어떻게 되시나요?
#전화번호#이요	넵 핸드폰 뒷자리로 적립 도와드렸습니다
감사합니다	음료 나왔습니다
음료 단체 주문 가능한가요?	네 언제 받으실 예정이세요?
오늘 오후 7시에 받으려고요	네 주문은 어떻게 하시겠어요?
아이스 아메리카노 30잔 해주세요	네 30잔 하셔서 총 12만 3천 원입니다
CJ one 포인트 번호로 적립할게요	네 앞 쪽에 번호 입력해주세요
혹시 포인트 얼마나 남았나요?	3천 점 있는데 사용해드릴까요?
아이스 라테 한 잔이	테이크아웃인가요?
매장에서 먹고 갈 거예요	할인되는 제휴카드 있으신가요?
엘지 VIP예요	사이즈 업해드릴게요
케이크 뭐가 잘 나가나요?	치즈케이크가 제일 잘나가요
치즈케이크도 주세요	네 포인트 적립까지 도와드릴게요
프리쿠폰 사용 가능한가요?	네 사용 가능합니다
프리쿠폰으로 어떤 음료를 주문할 수 있어요?	쇼케이스에 진열된 병음료를 제외한 모든 음료 주문 가능해요
사이즈는 어떤 걸로 주시는 거예요?	기본 레귤러 사이즈예요
라지 사이즈는 추가 금액이 있나요?	500원 추가하시면 됩니다
그럼 따뜻한 라테 라지로 한 잔이요	500원입니다
바닐라 라테 얼마예요?	3700원입니다
우유 종류 선택 가능한가요?	저흰 한가지 우유만 사용합니다
거품 적게 주실 수 있을까요?	네 가능합니다
휘핑 추가해주세요	그럼 500원 추가됩니다
캐리어에 담아주세요	네
아이스 아메리카노 하나 주세요	사이즈는 어떻게 드릴까요?
작은 사이즈로 주세요	네 4100원입니다
샷은 몇 개 들어가나요?	2개 들어갑니다
하나만 넣어주세요	네 연하게 만들겠습니다
현금되죠?	그럼요
아메리카노 두 잔 주세요	포장이신가요?
아뇨 매장에서 먹을 거예요	그럼 머그잔으로 드릴게요
네 그리고 치즈케이크 한 조각 주세요	네 그렇게 준비해드릴게요
화장실은 어디죠?	건물 안쪽으로 들어가시면 됩니다
화장지는 안에 있죠?	네 준비돼 있어요
녹차라테 있나요?	그린 티 라테 말씀이세요?
네 아이스로 하나 주세요	사이즈는 어떻게 해드릴까요?
그란데 사이즈요	위에 휘핑크림 올려드릴까요?
네 에스프레소 휘핑크림으로 많이요	네 5800원입니다
삼성페이 되죠?	네
카페라테 얼마에요?	4500원입니다
바닐라 시럽 추가되나요?	네 가능합니다
샌드위치랑 음료 세트도 있나요?	네 세트는 음료 2000원 할인됩니다
그럼 샌드위치랑 카페라테 주세요	네 드시고 가시나요?
포장해주세요	네 잠시만 기다려주세요
딸기 스무디 한 잔 주세요	죄송합니다 오늘 딸기가 소진돼서 딸기 음료는 주문이 안되세요
그럼 녹차 프라푸치노는 되나요?	네 주문 가능하세요
초코케이크 포장되나요?	포장은 두 조각 이상부터 가능하세요
그럼 초코케이크랑 치즈 케이크 포장해주세요	음료도 같이 포장해드릴까요?
네 같이 포장해주세요	알겠습니다
아메리카노 한 잔에 얼마인가요?	3500원입니다
이 음료는 새로 나온 음료인가요?	네 새로 나온 녹차라테입니다
녹차라테는 얼마인가요?	5000원입니다
휘핑크림이 올라가나요?	기본적으로는 올라가지만 취소하실 수 있습니다
그럼 아이스 한 잔으로 테이크아웃 해주시겠어요?	네 알겠습니다 고객님
주문할게요	네 주문 도와드리겠습니다
아메리카노 레귤러 사이즈 하나랑요 티라미수 하나요	포인트 있으신가요?
네 있어요	앞에 번호 눌러주세요
주차했는데 주차 증 발급은 어떻게 받나요?	앞에 차 번호 남겨 주세요
일회용 컵에 주세요	네 알겠습니다 준비되면 진동벨로 알려드릴게요
카페라테 한 잔 주세요	따뜻한 걸로 드릴까요?
아니요 아이스로 주세요	사이즈는요?
톨 사이즈로 주세요	더 필요하신 건 없나요?
네 기프티콘 되나요?	네 그럼요
현금영수증 되나요	네 번호 눌러주세요
아메리카노 한 잔은 얼마인가요?	4000원입니다
아메리카노 언제 나오나요?	5분 뒤에 나올 예정입니다
화장실은 어디 있나요?	2층에 있습니다
오렌지 주스는 있나요?	아니요
아메리카노에 샷 추가해주세요	네
아이스 바닐라 라테 얼마에요?	5500원입니다
얼마나 기다려야 하나요?	주문이 밀려 10분 정도 기다리셔야 합니다
먹고 갈 테니 머그잔에 주세요	네 알겠습니다
카드 결제할게요	네 카드 꽂아주세요
포인트 적립해주세요	네 포인트 적립됐습니다
아메리카노 한 잔 주세요	크기는 어떤 것으로 드릴까요?
작은 사이즈로 주세요	진하게 해드릴까요?
샷 하나 추가해주세요	샷 추가 시 추가금이 있습니다
얼마 추가되죠?	500원씩 추가돼요
시원한 걸로 해주세요	샷 추가 아이스 아메리카노 작은 사이즈 맞으시죠?
지금 딸기 스무디 2잔 주문 가능한가요?	죄송합니다만 지금 딸기가 다 떨어져서 어렵습니다
1잔도 안 되나요?	네 재료가 전혀 없어서요
그럼 딸기 에이드는 가능한가요?	네 가능합니다
스무디 종류 중에선 지금 어떤 것 주문되나요?	블루베리 스무디와 자몽 스무디 가능합니다
그러면 딸기 에이드 1잔이랑 블루베리 스무디 1잔 주세요	네 드시고 가시나요?
휘핑크림이 올라가는 커피가 뭐가 있죠?	카페모카와 캐러멜마키아토 두 가지가 있습니다
그럼 카페모카로 한 잔 휘핑크림 가득 올려주시고 혹시 커피에 샷 추가되나요?	샷은 500원을 추가로 내시면 가능하십니다
그러면 샷 추가 부탁드리고 앞에 진열된 쿠키는 얼마예요?	쿠키는 3000원입니다
쿠키도 같이 하나 부탁드릴게요	카페모카 한 잔 휘핑크림 가득과 샷 추가하셨고 쿠키도 함께 주문하셨습니다
네 그리고 제로 페이 가능한가요?	죄송합니다만 저희 매장은 제로 페이 가맹점이 아닙니다
저 아메리카노 아직 안 나오나요?	손님이 많아서 지연되고 있습니다
얼마나 더 기다려야 합니까?	3분만 기다려 주십시오
그럼 옥수수빵이랑 카푸치노 한 잔 구매할게요	네 7천 원입니다
만원 현금 되나요?	네 만원 받았고 3천 원 거스름돈입니다
그럼 혹시 3천 원짜리 텀블러 있나요?	그런 건 없습니다
아메리카노 한 잔 주세요	따뜻한 걸로 드릴까요?
아이스로 주세요	잠깐만 기다리세요
일회용 컵으로 주시는 건가요?	매장 내에서는 일회용 컵 사용이 안 됩니다
그럼 머그컵에 주세요	곧 준비해 드릴게요
설탕은 어디에 있나요?	출입문 오른쪽 탁자에 준비돼 있습니다
캐러멜마키아토 하나하고 컵케이크 한 조각 주세요	커피 사이즈는 어떻게 해드릴까요?
그란데로 주세요	드시고 가실 건가요?
여기서 먹을 겁니다	두 가지 합해서 17000원입니다
KT 멤버십 할인되나요?	네
카드하고 멤버십 카드입니다	잠시만 기다려주세요
아이스 아메리카노 한 잔 주세요	네 알겠습니다
혹시 샷 추가 가능한가요?	네 샷 추가 가능합니다
샷 추가는 얼마인가요?	원래는 500원 추가인데 오늘은 무료로 추가해 드릴게요
왜 무료예요?	낮에는 샷 추가 무료 제공 서비스를 하고 있어요
샷 추가 무료 제공은 언제까지 해요?	이번 주까지 진행됩니다
커피 주문했는데 생각보다 오래 걸리네요	죄송합니다 지금 많이 바빠서 그렇습니다
많이 바빠 보이시네요 왜 그렇게 바쁘시죠?	단체 주문이 들어와서 그렇습니다
그러면 제 커피는 언제 나오는지 알 수 있을까요?	15분 정도 소요될 예정입니다
저 말고도 대기인원 있나요?	3팀 정도 있습니다
그렇게까지 기다릴 수가 없어서 주문취소할게요 주문취소 가능한가요?	죄송합니다 주문취소 도와드릴게요
카페인이 들어가지 않은 음료는 무엇이 있나요?	차 종류나 스파클링 음료의 있습니다
캐머마일 따뜻한 건 얼마인가요?	3400원입니다
오미자 스파클링 음료는 얼마인가요?	5400원입니다
오미자 스파클링 음료는 주문하면 얼마나 걸릴까요?	5분 안에 나옵니다
테이크아웃 하지 않고 먹고 가려면 어떻게 해야 하나요?	자리 있는지 확인하시고 주문해주시면 벨로 알려드리겠습니다
아이스 아메리카노 한 잔 주세요	사이즈 어떤 걸로 드릴까요?
그란데 사이즈로 주세요	죄송한데 저희 가게에는 레귤러랑 라지 사이즈 밖에 없어요
라지 사이즈는 얼마에요?	5000원입니다
카드로 결제할게요	카드 받았습니다 도장 쿠폰 찍어드릴까요?
괜찮습니다	네 진동벨로 안내드리겠습니다
그린 티 프라푸치노 한잔 주세요	드시고 가시나요?
포장해주세요	일회용 컵에 담아드릴까요?
제 텀블러에 담아주세요	개인 텀블러 지참하시면 300원 할인됩니다
혹시 자바칩도 추가 가능한가요?	갈아드릴까요?
반은 갈고 반은 그냥 넣어주세요	4900원입니다
자바칩 프라푸치노 얼마에요?	6100원입니다
사이즈업하면 얼마에요?	그란데 사이즈 6600원입니다
치즈 케이크 있나요?	리코타 멜팅 치즈 케이크 있습니다
그럼 케이크도 한 조각 주세요	더 필요하신 건 없으세요
네 계산해주세요	12000원입니다
창가 쪽 자리 있나요?	저쪽에 있어요
아메리카노 따듯한 걸로 두 잔 주세요	곧 가져다드릴게요
오실 때 얼음 넣은 물 한 컵 부탁드려요	알겠습니다
시럽이나 설탕 있나요	저쪽에 셀프입니다
아메리카노 리필되나요	한 번만 리필됩니다
초코 바나나 스무디 되나요?	네 가능합니다
얼마인가요?	4300원입니다
초코 바나나 스무디 하나 주세요	휘핑크림 올려드릴까요?
네 올려주세요	드시고 가시나요?
네 먹고 갈 거예요	4300원 결제 도와드리겠습니다
여기 아메리카노 기프티콘 사용 가능한가요?	네 가능합니다
아메리카노 한잔하고 치즈 케이크 하나 주시겠어요?	치즈 케이크는 다 팔렸습니다
그러면 케이크 뭐 남았나요?	초코 가나슈와 티라미슈 케이크 남았습니다
티라미슈 케이크로 주세요	다른 거 더 필요한 건 없으신가요?
케이크는 카드로 결제 부탁드릴게요	카드 받았습니다
음료 사이즈는 뭐 뭐 있나요?	레귤러와 라지가 있습니다
그럼 아이스 아메리카노 라지 사이즈 샷 추가해주세요	샷 추가하시면 500원 추가되셔서 4700원입니다
마시고 갈게요	머그잔에 준비해드리겠습니다
마시다가 나가야 하면 어떻게 하나요?	테이크 아웃 잔에 옮겨 담아 드리겠습니다
와이파이 비밀번호는 어디에 있어요?	카운터 하단 왼쪽에 보시면 됩니다
커피 원두 종류가 어떻게 되나요?	과일 향이 나는 산미 나는 에티오피아와 나무 향이 나는 브라질 커피가 있습니다
우유 종류도 고를 수 있을까요?	우유는 한 가지입니다
그럼 아메리카노 주세요	따뜻한 아메리카노 맞으신가요?
네	드시고 가시나요?
아니요 테이크 아웃 잔에 주세요	네 4500원입니다
아이스 아메리카노 바로 되나요?	네 바로 됩니다
얼음은 갈아서 주세요	네 사이즈는 어떻게 해드릴까요?
레귤러로 부탁드립니다	네 이천 원입니다
쿠폰도 찍어주세요	네 알겠습니다
빨대는 안 주셔도 돼요	알겠습니다
아이스 아메리카노 한잔 얼마예요?	5000원입니다
샷 추가되나요?	네 가능합니다
요즘 제일 잘나가는 케이크는 뭐예요?	치즈케이크가 제일 잘나가요
그럼 치즈케이크 하나 주세요	네 더 필요하신 건 없으신가요?
포인트 적립되나요?	네 적립하실 번호 알려주세요
아이스 카페모카 하나 주세요	위에 휘핑크림 올려드릴까요?
휘핑크림은 빼주세요	더 필요하신 거 있으세요?
없어요	드시고 가세요 아니면 테이크아웃이세요?
테이크아웃이요	포인트 적립해 드릴까요?
아니요 포인트 없어요	총 4500원입니다
바닐라라테 있나요?	저희 매장에는 바닐라라테가 없습니다
그럼 비슷한 맛의 커피가 있나요?	딜라이트 라테가 있습니다
가격은 얼마인가요?	오천육백원입니다
아이스 딜라이트 라테로 한 잔 주세요	계산 도와드리겠습니다
현금으로 계산 가능한가요?	저희 매장에는 카드 결제만 가능합니다
아이스 아메리카노 한 잔 주세요	4300원입니다
리필 가능한가요?	1000원 추가요금 내시면 가능합니다
제 텀블러에 담아주세요	텀블러 한 번 씻어서 담아드릴까요?
네 부탁드려요	진동벨로 알려드리겠습니다
영수증은 버려주세요	알겠습니다
우유를 두유로 변경 가능한가요?	가능합니다
카페라테에 두유로 변경해서 주세요	사이즈는 어떤 걸로 하시나요?
톨 사이즈로 주세요	시럽 넣어 드릴까요?
아니요	4600원입니다
현금영수증 해주세요	번호 입력해주세요
이 매장에서 블랙 슈거 버블티를 파나요?	저희 매장에서는 블랙 슈거 버블티를 팔지 않습니다
그럼 아이스초코에 샷 추가되나요?	됩니다
포인트 있는데 포인트로 결제되나요?	가능하세요
포인트로 결제한 것도 적립이 되나요?	안됩니다
준비되면 이 번호로 문자를 주실 수 있나요?	죄송하지만 안됩니다
디카페인 커피 있나요?	네 모든 커피를 디카페인으로 준비해드릴 수 있어요
그럼 라테를 디카페인으로 해주세요	따뜻한 걸로 드릴까요?
아뇨 아이스로 해주세요	네 진동벨로 알려드릴게요
티라미슈 한 조각엔 얼마예요?	5500원입니다
티라미슈도 하나같이 주세요	네 총 만 원입니다
아이스크림 주문 가능한가요?	3가지 종류 아이스크림이  있습니다
디카페인 커피 주문 가능한가요?	네 그럼요
카페모카 위에 휘핑크림 빼고 주세요	네 알겠습니다
조각 케이크 말고 홀 케이크도 있나요?	네 준비되어 있습니다
커피는 텀블러에 담아주세요	네 알겠습니다
커피 테이크아웃 가능할까요?	네 가능합니다
혹시 디카페인도 있나요?	아메리카노 라테 메뉴 디카페인 주문 가능합니다
아메리카노 2잔 카페라테 2잔 디카페인으로 테이크아웃해주세요	네 캐리어에 담아드릴까요?
네 티슈도 넉넉하게 챙겨주세요	혹시 아메리카노에 시럽 넣어드릴까요?
아니요 두 잔 다 그냥 주세요	네 금방 준비해드리겠습니다 잠시만 기다려주세요
주문해도 될까요?	네 말씀 해주세요
초코 라테 1개 아메리카노 5잔이요	사이즈는 어떤 걸로 하시죠?
전부 라지로 주세요	포인트나 멤버십 있으세요?
아니요 계산은 현금으로 할게요	진동벨로 불러드릴게요
포장인데 앉아있어도 되죠?	자리 많으니까 편하신 대로 하세요
카페라테 하나 주세요	차가운 걸로 드릴까요 따뜻한 걸로 드릴까요
따뜻한 걸로 주세요	네 4500원입니다
이 모바일 쿠폰 사용 가능한가요?	한 번 확인해보겠습니다
안 되면 카드 결제로 할게요	아니에요 쿠폰 사용 가능하시네요
현금영수증도 해주세요	네 핸드폰 번호 입력해주세요
아메리카노 얼마에요?	5000원이에요
포인트 적립 가능해요?	네 포인트 적립해드려요
할인되는 카드 있나요?	할인되는 건 없어요
아가 먹을 음료도 있나요?	과일주스 있어요
포장 가능하죠?	주문하시면 해드려요
여기 쿠폰 사용 가능한가요?	네 가능합니다
이게 아메리카노 무료 쿠폰인데 다른 음료로 변경되나요?	네 금액을 추가하시면 다른 음료로 변경 가능합니다
그러면 슈크림 라테로 주세요	사이즈는 어떻게 드릴까요?
톨로 주세요	그러면 1500원을 추가 결제해주시면 됩니다
쿠폰은 여기 있습니다	쿠폰 받고 나머지 금액은 어떻게 결제하시겠습니까?
여기 몇 시까지 영업하나요?	밤 10시까지입니다
아이스 카페모카 하나 주세요	휘핑 올려드릴까요?
네 많이 올려주세요	알겠습니다 드시고 가시나요?
아니오 테이크아웃 할 거예요	네 5500원입니다
아이스는 더 비싼가요?	HOT보다 500원 비쌉니다
아이스 카페라테 한 잔에 얼마인가요?	4000원입니다
샷 추가하는데 추가 가격이 있나요?	300원 추가됩니다
시럽 추가 혹시 가능한가요?	어떤 시럽 추가하고 싶으세요?
바닐라 시럽 추가되나요?	그러면 바닐라 라테는 어떠세요?
바닐라 라테 아이스로 한 잔 주세요	4500원 결제 도와드리겠습니다
아메리카노 한 잔 주세요	차가운 음료 따뜻한 음료 어떤 거로 드릴까요?
차가운 걸로 주세요	사이즈는 뭐로 하시겠어요?
제일 큰 거로 주세요	드시고 가실 건가요?
매장에서 먹고 갈 거예요	5000원입니다
여기요	진동벨 받으시고 잠시만 기다려 주세요
아이스 아메리카노 한잔 주세요	사이즈는 어떻게 드릴까요?
어떤 종류 사이즈가 있나요?	스몰과 라지 있습니다
라지로 주세요	5500원입니다
카드 결제할게요	쿠폰 있으신가요
여기 찍어주세요	네 잠시만 기다려주세요
지금 주문 가능한가요?	네 주문해주세요
디카페인 콜드브루 있나요?	디카페인 콜드브루는 없습니다
다른 디카페인 메뉴 좀  추천해주세요	디카페인 카페라테는 어떠세요?
그럼 카페라테 디카페인으로 한 잔 주세요	네 결제는 어떻게 도와드릴까요?
카카오페이 가능하죠?	네 바코드 입력해주세요
아이스 아메리카노 2잔에 얼마인가요?	8600원입니다
초코케이크는요?	4500원입니다
그러면 아이스 아메리카노 2잔과 초코케이크 1개 네이버 파이로 결제 가능한가요?	네 됩니다
네 그러면 결제해주세요	포장인가요?
여기서 먹고 가려고요	네 13100원입니다
돌체 라테 한 잔에 얼마에요?	5900원입니다
디카페인으로 가능한가요?	네 가능합니다
그럼 아이스로 한잔 주세요	네 아이스 돌체 라테로 준비해드리겠습니다
제 텀블러에 담아주시면 할인되죠?	네 할인 가능합니다
네 제 텀블러에 담아주시고 결제하고 현금영수증 처리할게요	네 번호 입력해주세요
주문할게요	어떤 걸로 드릴까요?
아이스 아메카노 한잔 주세요~	4천6백 원 결제 도와드리겠습니다
베이글도 하나 주세요	크림치즈 추가해 드릴까요
네 추가해주세요	준비되면 알려드리겠습니다
빨리 부탁드려요	네 빨리 준비해 드리겠습니다
아이스 아메리카노 2잔 주세요	네 8000원입니다
혹시 삼성 파이로 결제 가능해요?	네 그럼요
그럼 이걸로 결제해 주세요	네 잠시만요
아 혹시 포인트 적립돼요?	네 전화번호 눌러주세요
얼마나 쌓였어요?	5000점 있으시네요
옆 가게에서 국수 안 먹으면 할인 안되죠?	예 식사하시고 오시면 할인해드립니다
케이크 같은 것도 있어요?	케이크는 없고 빵이랑 간단하게 드실 건 있어요
저 음료는 커피 들어있나요?	저 음료에는 소량의 향 정도만 들어있습니다
이건 보리찰떡인가요?	네 안에 팥이 들어있는 보리찰떡입니다
보리찰떡 하나 하고 아메리카노 한 잔 주세요	따뜻하게요?
예 따뜻하게 주세요	드시고 가시겠어요?
네 먹고 갈게요	할인해서 총 오천 원입니다
시나몬 조금 뿌려주세요	네 시나몬 뿌려 드리겠습니다
남은 거 좀 싸줄 수 있어요?	조금밖에 안 남았는데 포장해드릴까요?
네 작은 컵에 담아주세요	네 작은 컵에 담아 드리겠습니다
빵은 여기서 만든 거에요?	아뇨 콩빵만 매장에서 굽습니다
초코라떼 있어요?	초코라떼 따뜻한 거 찾으세요?
네 맞아요	네 핫초코 있습니다
쌀라떼는 뭐에요?	쌀라떼는 곡물라떼 같은 거에요
곡물라떼 사진은 어디있어요?	곡물라떼 사진은 첫 번째입니다
곡물라떼 따뜻해요?	네 따뜻하게 가능하세요
곡물라떼 얼만데요?	곡물라떼는 기본 사이즈에 육천백 원이에요
티바나는 뭐에요?	네 티바나는 티 종류 나가고 레몬티나 라임티도 따뜻하게 같이 됩니다
메뉴판 두 번째 메뉴는?	홍차 라떼예요
블루베리 머핀하고 플래시 구콘 주세요	네 드시고 가시죠?
네 따뜻하게 해주실 수 있나요?	네 따뜻하게 해드리겠습니다
카드는 기계에 꽂는게 맞나요?	네 카드 반대로 꽂아주시면 돼요
쉬는 날이 없어요?	네 저희는 쉬는 날이 없어요
주말에는 자리가 없죠?	네 주말에는 더 자리가 없어요
원두를 좀 많이 태우나요?	네 저희는 로스팅을 많이 해요
모든 메뉴를 강하게 로스팅해요?	네 아닌 것도 있어요
행사 같은 건 안 하나요?	행사 같은 건 잘 안해요
회원카드는 얼마에 사용 가능한가요?	회원카드는 오천 원부터 충전하시면 됩니다
회원카드는 충전해서 사용하는거에요?	네 교통카드처럼 만 원이면 만 원 충전해서 사용하면 됩니다 
회원비는 있나요?	아뇨 없어요
회원카드를 많이 쓰면 혜택이 있나요?	등급마다 혜택이 다른데 한 번 결제 할 때마다 별이 올라가니까 사용 빈도수에 비례하고 다달이 별을 드리는 이벤트도 있어요
테이크아웃 해주세요	네 테이크아웃 해드리겠습니다
커피 종류 테이크아웃하면 더 싸요?	네 천 원씩 더 저렴해요
카라멜 마끼아또는 뭐에요?	카라멜 마끼아또는 카라멜 소스가 들어가서 조금 단 음료입니다
카라멜 소스를 위에 올려주나요?	카라멜 소스는 우유에 넣어드립니다
카라멜 마끼아또 엄청 달겠네요?	네 단 거 좋아하시면 괜찮으실거에요
핑크 솔트 비엔나는 소금이 들어갔다는 거에요?	아메리카노 크림에다가 핑크 소스랑 소금을 올려서 단맛과 짠맛을 좋아하시는 분들이 선호합니다
핑크 솔트비엔나에 우유도 들어가요?	우유는 안들어가고 아메리카노 위에 올려드려요
카라멜 마끼아또 포장 해주실래요?	시원하게 해드릴까요?
카라멜 마끼아또 따듯하게 해도 되나요?	네 가능합니다
스몰사이즈로 우유가 안 들어간게 아메리치노인가요?	네 아메리치노에는 우유가 들어가지 않습니다
아메리치노가 무슨 말이에요?	아메리카노와 맛은 똑같은데 아메리치노에는 우유 거품이 아닌 커피 거품층이 있어요
스몰보다 더 작은 사이즈는 없나요?	네 스몰사이즈가 제일 작아요
유자차 따뜻하게 스몰사이즈로 마시고 갈게요	네 할인되는 카드 없으세요?
할인이랑 적립은 어떤 카드가 되죠?	오케이캐시백 포인트 할인 가능하시고 적립은 롯데카드로 가능합니다
통신사 할인은 안되나봐요?	통신사는 SKT브로드밴드 브이아이피 이상이시면 가능하세요
그냥 결제해주세요	네 머그잔에 담아드릴게요
사장님 여기 찬물 조금만 떠주세요	네 찬물 갖다드릴게요
판매용 더치커피는 없어요?	네 더치커피는 판매하지 않고있습니다
카페 용품은 이게 다에요?	예 용품은 진열되어 있는 게 다예요
몇 시까지 해요?	열한시까지 합니다
샤케라또가 뭐에요?	에스프레소하고 얼음을 쉐이크 한 거에요
샤케라또는 아이스네요?	네 아이스입니다
아포가토는?	아포가토는 아이스크림에 에스프레소를 넣어서 떠 먹는 메뉴입니다
아메리카노 주세요	따뜻하게 드릴까요?
네 따뜻하게 해주세요	네 머그잔에 담아드릴게요
마시던거 싸주실 수 있어요?	네 포장해드리겠습니다
형광커피가 뭐예요?	형광커피는 에스프레소와 얼음을 칵테일 쉐이커에 넣어서 만든 샤케라또인데 저희는 기계를 이용해서 거품이 조금 굵어요
형광커피는 아이스네요?	네 여름에 드셔보시면 맛있어요
칵테일도 있어요?	예 칵테일은 도수가 센 편인데 여성분들은 화이트 칵테일이라고 거품이 좀 들어있는 걸 선호하세요
로스팅은 얼마나 해요?	로스팅은 저희 협회에서 해오고 업소에서는 내리기만 합니다
적립도 되나보네요?	네 드실 때마다 한 개씩 찍어드리고 열 개 채우시면 아메리카노 하나 드립니다
여기 체인점이에요?	네 체인점입니다
메뉴 글씨가 너무 작아요	메뉴를 바꾸는김에 종류를 줄이려해서 시간이 좀 걸리네요
아메리카노 주세요	따뜻하게요?
네 테이크아웃으로 주세요	네 테이크아웃 해드리겠습니다
영수증 주세요	네 영수증 드리겠습니다
헤이즐넛도 시럽이에요?	네 헤이즐넛 시럽도 있습니다
음료에 카라멜 시럽을 넣기도 해요?	헤이즐넛이나 카라멜 시럽은 자체적인 향 때문에 주로 넣어요
카라멜 시럽 넣어주실 수 있어요?	카라멜 시럽 넣으면 오백 원 추가됩니다
테이크아웃은 더 싼가요?	아니요 저희는 똑같아요
아메리카노 뜨거운 걸로 하나 주세요	네 잠시만요
더치커피도 있어요?	더치커피는 없어요
텀블러 가져오면 할인해주시나요?	저희는 텀블러 할인이 안됩니다
카카오페이도 돼요?	카카오페이로는 결제가 안됩니다
삼성페이는 되고요?	네 삼성페이는 됩니다
그냥 결제해주세요	네 영수증 드리겠습니다
여기 샷이 몇 개에요?	투 샷이에요
네 테이크아웃으로 해주세요	아메리카노 진하게 해드릴까요?
저는 한 샷 반 정도가 좋은 거 같아요	저희 매장은 큰 잔이어서 투 샷 들어가도 괜찮으실거에요
이게 몇 미리죠?	이게 육백미리 정도 됩니다
카페 생긴 지 얼마나 됐나요?	일년 좀 넘었어요
원두는 로스팅 된 거 사 오시나요?	네 저희는 원두 주문하는 곳이 있습니다
신세계 포인트 사용이 되어있는데 신세계랑 관련이 있어요?	네 저희는 신세계 계열 스타벅스라서 전국 어디서든 신세계 적립과 상품권 사용이 가능합니다
아메리카노 제일 작은 사이즈가 뭐에요?	네 숏 사이즈 있어요
아이스 아메리카노 숏사이즈로 돼요?	아뇨 아이스는 톨 사이즈부터 가능하세요
톨 사이즈로 아이스 아메리카노 하나 주세요	네 아이스 아메리카노 톨사이즈로 준비해드리겠습니다
오늘의 커피는 뭐에요?	매일 다른 원두를 쓰는 커피인데 오늘은 신 맛이 조금 나는 케냐 원두입니다
라떼 작은 거 하나 주세요	네 라떼 톨 사이즈로 드릴까요?
네 맞아요	아이스 아메리카노랑 라떼 모두 머그잔으로 도와드릴까요?
네 먹고 갈거에요	네 머그잔으로 드리겠습니다
여기 샌드위치 있나요?	샌드위치는 가지고 오시면 바코드 찍어드릴게요
샌드위치 데워주기도 하나요?	네 데워드려요 
신세계 상품권으로도 결제 되나요?	네 현금영수증 필요하세요?
일반영수증 하나 주세요	네 신세계 상품권으로 팔천칠백 원 결제해드리겠습니다
라떼에 시럽 한 번만 넣어주세요	고객님 시럽은 바에서 셀프로 이용 가능하세요
자리는 아무 데나 앉으면 돼요?	네 빈 자리에 앉으시면 됩니다
허니 바게트빵 이거는 뭐에요?	예 그건 바게트빵이에요
데워 주는 거죠?	네 데워서 드립니다
카푸치노 와플도 있는데 이건 커피 맛이 나나 봐요?	카푸치노 와플에는 계피가루가 들어갑니다
밖에 프라이팬은 뭐예요?	프라이팬은 스무디 종류입니다 
새로운 게 먹고 싶은데 카모마일은 차 종류 맞나요?	네 카모마일은 차 종류예요
아이스 아메리카노 한 잔 주세요 	네 아이스 아메리카노 한 잔 드리겠습니다
카페 비엔나는 달아요?	아메리카노 위에 생크림 휘핑이 올라가 있는 메뉴입니다 
따뜻한 아메리카노 위에 휘핑이 올라가요?	네 커피는 쓰지만 위에 휘핑 크림이 올라가서 잘 어울립니다
카페 비엔나 한 잔 주세요	드시고 가시죠?
네 여기서요	네 준비되면 불러 드리겠습니다
쿠키슈는 안에 뭐가 들어있는 거예요?	쿠키슈 안에는 크림이 들어있습니다
밀크티 라떼 따뜻한 음료라고 했죠?	네 밀크티 라떼는 따뜻한 음료입니다
밀크티 라떼랑 카페라떼랑 뭐가 달라요?	밀크티 라떼는 홍차 베이스에 우유가 들어간거고 카페라떼는 커피 샷이 들어가요
사진에 있는 게 밀크티 라떼죠?	네 그게 밀크티 라떼입니다
영수증 주시면 안 될까요?	네 영수증 드리겠습니다
햄 치즈 크로와상 데워 주실 수 있나요?	네 포장이세요?
아니요 여기서 먹으려고 하는데요	사천오백 원 결제 도와드릴게요
아이스 아메리카노 사이즈업 해주실 수 있나요?	네 아이스 아메리카노 그란데 사이즈로 한 잔 드릴까요?
네	구천오백 원 결제 도와드리겠습니다
혹시 여기 주차했는데 뭐 되나요?	주차는 나가시면서 영수증 보여주시면 됩니다
여기 물은 어디 있어요?	물은 셀프바에 보시면 있습니다
혹시 여기 작은 컵 있나요?	작은 컵은 유상이라 돈을 내셔야 해요
물티슈랑 냅킨 두 개 줄 수 있어요?	네 물티슈랑 냅킨 두 개 드리겠습니다
음료 리필은 돼요?	그란데 사이즈는 리필이 안 됩니다
나중에 오면 리필 할 수 있나요?	네 드시던 잔 들고 오시면 저희가 천오백 원에 리필 해드립니다
주문은 카운터에서 하면 돼요?	네 주문은 카운터에서 도와드리겠습니다
제가 해피머니에서 요기요 아이스 아메리카노 선물 받았는데 사용가능한가요?	네 아이스로 드릴까요?
네 결제해 주세요	적립은 없으세요?
네 없어요	음료는 드시고 가세요?
네 여기서 먹을 거예요	현금영수증 필요하세요?
아뇨 사이즈업은 천이백원을 더 내야하나요?	네 사이즈업은 천이백원이 추가됩니다
커피 꿀복숭아 망고는 뭐예요?	커피 꿀복숭아 망고는 스무디 종류입니다
카페라떼 따뜻한 거 작은 사이즈로 주세요	네 카페라떼 따뜻한 거 작은 사이즈 하나 드리겠습니다
적립은 번호 찍을게요	네 번호 찍어 주세요
니트로커피가 뭐예요?	니트로커피는 콜드브루에 질소를 넣어서 거품이 있는 음료입니다
와플은 하는데 시간이 좀 걸려요?	네 와플은 9분정도 걸립니다
번에 치즈가 들었어요?	치즈가 들어가는 번은 없고 오리지널 번입니다
번은 따뜻하게 데워주는 거죠?	네 번은 오븐에 구워드려요
오리지널이 천구백원 맞죠?	네 오리지널 번은 천구백원입니다
커피 가루인데 카페라떼로 되어있는 거 있나요?	네 믹스커피처럼 집에서 타드시면 됩니다
텀블러 같은 거 팔아요?	지금은 텀블러 종류를 팔지 않습니다
커피 남은거 종이컵에 담아가도 되죠?	네 종이컵 드리겠습니다
메뉴판 어디 있어요?	메뉴판 드리겠습니다
딸기라떼에는 뭐가 들어있어요?	딸기라떼는 생과일 딸기에 우유 넣은거에요
콜드브루 아인슈페너는 뭔데요?	콜드브루 아인슈페너는 콜드브루 원액에 생크림 넣은 거에요
시원한 음료 종류는 어디 있어요?	시원한 음료 종류는 아래에 보시면 있습니다
아이스티도 시원하죠?	네 아이스티는 시원한 음료입니다
아이스티 한 잔만 주세요	네 아이스티는 사천 원입니다
주차장은 가게 맞은편 맞나요?	네 가게 바로 옆에 큰 주차장에서 무료로 사용 가능합니다
카카오페이 결제 돼요?	아뇨 저희는 삼성페이만 돼요
나중에 친구들하고 모임 할 예정인데 애완견 데리고 와도 돼요?	애완견을 풀어놓으시면 안 되고 안고 계셔야 돼요
콜드브루 파는 거에요?	네 세 개 사시면 하나 더 드립니다 
물에 타 먹으면 되는 거죠?	네 물이나 우유에 타드시면 돼요
고소한 원두 한 병 주세요	네 고소한 원두 한 병 드리겠습니다
샷 한 번만 넣으면 되나요?	저희는 삼대일로 나가는데 고객님이 좀 진하다 느끼시면 오대일이나 육대일까지 하셔도 돼요
내가 라떼를 좋아하는데 어떤 원두가 괜찮을까요?	브라질 원두랑 라떼가 잘 어울려요
아무래도 향이 더 진할 텐데 잘 어울릴까요?	네 브라질 원두는 저희 매장에서도 쓰는 원두입니다
로얄 밀크티는 뭐에요?	로얄 밀크티는 홍차에 티백이 들어간 음료입니다
커피가 들어간 거에요?	아뇨 커피는 들어가지 않습니다
베리민트는요?	베리민트도 홍차에요
맛은 똑같은 거에요?	얼그레이는 얼그레이 맛이 나고 민트는 민트 맛이 납니다
아트라떼는 솔티치즈랑 다르게 커피가 들어가는 건가요?	네 아트라떼는 커피가 들어갑니다
솔티치즈 카페라떼 하나만 주세요	따뜻한 거로 드릴까요?
네 따뜻한 걸로 주세요	네 따뜻한 걸로 드리겠습니다
주차 잠깐 해도 돼요?	옆 매장이 맘스터치라서 주차는 불가능합니다
그럼 세울 데는 없어요?	가게 근처 빈자리에 대시면 됩니다
주차 단속은 안하려나?	네 주자 단속은 안 합니다
많이 안 달죠?	네 달지 않습니다
커피 말고는 뭐 있어요?	커피 말고는 라떼도 있고 주스도 있습니다
어떤 게 잘 나가요?	라떼는 곡물라떼와 고구마 라떼가 잘나가고 주스는 블루베리나 아로니아가 잘 나갑니다
망고는 뭐에요?	망고는 시원해서 젊은 사람들이 선호합니다
블루베리 주스 잘 나가요?	블루베리는 냉동 제품을 사용한거라 따듯한거 드시고 싶으면 곡물라떼 한 번 먹어보세요
블루베리 주스 한 잔 주세요	네 블루베리 주스 한 잔 드릴게요
영수증 하나만 주세요	저희 가게는 현금 결제 시 영수증이 안 나옵니다
곡물 라떼는 뭐 들어가요?	곡물 라떼는 곡물 가루를 사용하고 우유 거품을 같이 넣어드려요
블루베리 주스에는 시럽 들어가요?	시럽 안 넣고 싶으시면 말씀해주세요
시럽 조금만 넣어주세요	네 시럽은 조금만 넣어드릴게요
사장님 냉동 블루베리에 시럽만 넣었죠?	우유도 들어갔습니다
오늘은 몇 시까지 해요?	여섯시까지 합니다
돌체라떼인가 연유 들어가는거 있어요?	네 연유 들어가는거 있어요
연유 말고 또 뭐 들어가요?	무지방 우유도 들어가요
아메리카노 하나 따뜻한 걸로 주세요	돌체라떼 말고 아메리카노 드릴까요?
네	사이즈는 톨사이즈로 하세요?
네 톨사이즈로 주세요	네 삼천팔백 원입니다
아메리카노 많이 뜨거워요?	아메리카노는 좀 뜨거워요 
주차는 가게 앞에 하면 돼요?	저희 주차장은 산부인과 뒤에 있습니다
은색 텀블러 얼마에요?	텀블러 뒤에 가격표 확인 가능합니다
사장님 커피 메뉴판 어딨어요?	여기 있습니다
사장님 허니 브래드는 직접 만드신거에요?	네 직접 만들었습니다
수제와플이랑 토스트랑 케이크 중에 어떤 게 잘 나가요?	다 비슷해요
수제와플 하나 주세요	한 개 드릴까요?
네 사장님 차는 어디 세우고 들어오면 돼요?	상가 주차장에 세우시면 돼요
사장님 더치커피는 이 큰병에 만삼천 원이에요?	옆에 있는 더치커피가 만 삼천원 입니다
핸드드립이랑 콜드브루는 뭐가 달라요?	핸드드립은 저희가 손으로 내리는 거고 콜드브루는 더치로 차게 내리는 음료입니다
핸드드립커피 주세요	핸드드립 하우스블렌드 에이랑 비 중에 고르시겠어요?
비 따뜻한거 한잔이랑 콜드브루로 주세요	콜드브루 한 잔 맞으세요?
콜드브루는 따뜻한 거에요?	콜드브루는 차가운 거밖에 없어요
여기 톰과 제리 치즈 모양 생긴게 치즈 케이크인가요?	네 치즈케이크에요
여기는 주차는 어디다 해요?	차 갖고 오셨으면 지하 주차장에서 차 등록 해드릴게요
여기 생긴 지 얼마나 됐어요?	저희 일년 정도 됐습니다 
금방 만든 거 있어요?	예 몇 개 드릴까요?
고로케 얼마씩 해요?	고로케 한 개에 이천 원입니다
고로케 안에 뭐가 들었어요?	계란하고 감자가 들어있습니다
팥 도너츠도 이천 원이에요?	예 이천 원입니다
단팥 도너츠 하나하고 고로케 하나 주세요	네 여기 보시면 팥빵도 있습니다
베이커리하고 카페하고 같이 하시죠?	네 음료도 팔고 있습니다
그 빵은 뭐에요?	고구마 빵이에요
그 빵은 얼마에요?	오천구백 원입니다
이 빵은 뭐에요?	새로 나온 핫도그 빵이에요
이빵은 얼마에요?	그건 이천오백 원입니다
우리 고로케 한 개 더 주세요	육천 원입니다
영수증 하나만 주세요	예 여기 있습니다
젤라또 통에다 넣어주세요	네 가지 맛이 들어가는 작은 통에 넣어드릴까요?
네 어떤 맛이 잘 나가나요?	녹차랑 티라미수도 맛있고 치즈 좋아하세요?
네 치즈도 괜찮아요 	치즈도 잘 나가고 블루베리도 괜찮아요
그렇게 네 가지 넣어주세요	네 드시고 가시는 거 맞죠?
예 영수증 좀 주세요	예 여기 있습니다
여기는 주차 할 데는 없죠?	주차공간은 없습니다
머랭쿠키도 직접 만드신 거에요?	쿠키는 우리가 받아서 해요
저건 삼천오백 원 맞죠?	네 삼천오백 원입니다
케이크 종류 파시는데 커피도 파시는 건가요?	네 둘다 판매 하고 있습니다
몰디브라떼는 뭐에요?	카페라떼에 시럽이 들어가는데 그것보다는 카라멜라떼나 카페모카를 더 추천해드릴게요
여기 오늘의 커피라고 있다고 하던데 그건 뭐에요?	드립커피에요
일반 아메리카노랑 같은 거에요?	아메리카노와 달리 산미가 좀 높고 카페인에 민감하신 분들이 많이 드세요
제조용법이 다른 거에요?	다른 건 아니고 아메리카노는 기계를 사용해서 고온 고압으로 내리는데 오늘의 커피는 드립 기계로 내려요
사이즈는 어떻게 돼요?	사이즈는 둘 다 톨 사이즈와 숏 사이즈 됩니다
가격은요?	아메리카노는 삼천백 원 드립은 삼천팔백 원이에요
삼천팔백 원짜리 드립커피 하나 주세요	내리는데 오분 정도 걸리는데 괜찮으실까요?
네	드시고 가시구요? 
네	따뜻한 오늘의 커피 톨 사이즈로 드리면 될까요?
네	현금영수증 하시나요?
네 이층에도 자리가 있나요?	있지만 진동벨이 따로 없어서 음료는 받고 올라가셔야 돼요
여기 물은 따로 없나요?	정수물 드릴까요?
네 조금만 주세요	음료 젓는 거 드릴까요?
네 시럽은 따로 주나요?	시럽은 저쪽 뒤에 보시면 있어요
여기 커피 말고는 음료수 뭐 있어요?	생과일 네 종류 있고 허브 차도 있고 에이드도 있어요
안 차가운건 없어요?	다 따뜻하게 가능해요
초콜렛 같은 건 없나요?	있습니다
더블 모카가 초코라떼에요?	네 맞아요
커피는 안들어가죠?	커피는 안들어갑니다
사이즈가?	작은 거랑 큰 거 가능하세요
작은 거 하나 주세요	드시고 가세요?
아뇨 가지고 갈게요	사천이백 원 결제 도와드릴게요
네 여기는 할인되거나 이런 카드 없죠?	카드는 없습니다
혹시 쿠폰은 있어요?	저희 매장에 포인트 등록하시면 적립 해드려요
사용 금액의 몇 퍼센트 적립돼요?	오 퍼센트 적립됩니다
영수증 좀 주세요	네 잠시만요
여기 오전에는 몇 시에 문 열어요?	오전 열시에 오픈이에요
초코음료는 뭐 어떤 거 있어요?	아이스초코랑 초코스무디요
스무디는 얼음 넣어서 갈은 거죠?	네 맞아요
핫초코 하나만 주세요	핫초코는 생크림 올라가는데 괜찮으세요?
생크림은 빼고 우유만 넣어주세요	오천육백 원이요
여기는 할인은 따로 없어요?	네 할인은 따로 없고 해피포인트 적립 가능하세요
에스케이 할인은 안돼요?	통신사 할인은 안됩니다
영수증 좀 주세요	네 바로 드리겠습니다
여기 화장실은 어딨어요?	화장실은 이층에 있어요
화장실 문 잠겼던데?	이층에 열려있습니다
이층은 어디로 올라가요?	옆 계단으로 올라가시면 됩니다
배달도 하나요?	배달 합니다
뭐가 맛있어요?	따뜻한 거랑 시원한 거 중에 어떤 거 찾으세요?
따뜻한 거요	따뜻한 거 중에는 레몬 티와 생자몽 티가 있습니다
생자몽 티 따뜻하게 한 잔 주세요	가져가실 거예요?
아뇨 여기 적립도 해요?	예 쿠폰 찍어 드릴게요 
할인도 하나요?	할인은 따로 없고 적립만 가능하세요
적립할 때 여러 명이 오면 어떻게 하나요?	잔 수에 따라 찍어드립니다
자몽 티 덜 달게 되나요?	예 덜 달게 해드릴게요
자몽 청은 여기서 만드신거에요?	제가 만든 거에요
아까 영수증 안 주셨어요	드릴게요
따뜻한 거는 더 싼 가봐요	삼천오백 원입니다
배달 시킬 수 있게 명함 한 장 주실 수 있나요?	네 여기 있습니다
커피 들어가는 음료 중에 덜 단 게 있나요?	라떼가 제일 안 달고 바닐라 라떼 같은 경우 시럽 빼어드릴 수 있어요
카페 라떼로 주세요	사이즈는 어떻게 드릴까요?
작은 걸로 주세요	드시고 가세요?
예 테이크아웃 하면 더 저렴해요?	아니요 가격은 똑같습니다
적립용 카드 하나 만들어 주세요	바로 만들어 드리겠습니다
여기는 스타벅스처럼 럭키백 행사는 안하나요?	네 따로 그런 건 없어요
뚜껑 안 닫아 주셔도 돼요	네 알겠습니다
아메리카노 주세요	따뜻한 거 드릴까요?
예	드시고 가시는 거에요?
테이크아웃은 더 싼가요?	가지고 가시면 오백 원 할인돼요
테이크아웃으로 해주세요	네 이천오백 원 결제할게요
시럽은 빼주세요	시럽 뺴드리겠습니다
마시고 갈게요	머그잔에 드릴게요
예 영수증도 하나주세요	네 영수증 드릴게요
네 여기는 네일도 같이 하나요?	네 같이 하고 있습니다
커피랑 네일은 별도로 운영하시는 건가요?	별도로 운영합니다
청을 직접 만들어 갖고 파나봐요	네 레몬이랑 자몽청 만들어서 판매하고 있어요
사장님 커피에 얼음 세 개만 넣어주세요	네 따로 드릴게요
사장님 이런 잔은 얼마에요?	원래 이만 칠천 원인데 현금하시면 이만 천육백 원이에요
제가 지금 먹는 잔 맞죠?	맞아요
이거 아이스 팬은 밀크하고 블랙하고 어떻게 달라요?	둘 다 차가운 것만 가능한데 밀크는 우유가 들어가서 고소하고 블랙은 물이 들어가서 깔끔합니다
커피가 들어갔나요?	네 둘 다 더치커피가 들어가요
라떼 종류 중에 안 단 건 어떤 게 잘 나가요?	라떼가 아예 안 달고 바닐라나 나머지 커피류는 전부 달달해요 
애플 시나몬이 신메뉴인가요?	저건 없어요
더치 커피하고 더치 라떼가 있네요?	물 들어가고 우유 들어가고 차이에요
더치 라떼 따뜻한거 하나 줘요	시럽 조금만 넣을까요?
네 조금만 넣어주세요	삼천 원 결제할게요
이 카드로 해주세요	쿠폰 하나 드릴까요?
네 영수증도 하나 주세요	네 여기 있습니다
시럽은 약간만 넣었나요?	조금 넣었어요
미숫가루 라떼 종류가 되게 많네요?	그거는 커피가 안 들어가는 라떼에요
생강 차는 생강 분말 들어가요?	생강 청이랑 생강 가루가 들어갑니다
생강 수삼주스는 뭐에요?	수삼이랑 우유 갈아서 나가는 거에요
수삼주스는 얼마에요?	오천오백 원입니다
그러면 아메리카노 따뜻한 거 한 잔 주세요	이천팔백 원 결제 도와드릴게요
예 마시고 갈거에요	영수증 필요하세요?
예 이건 수제쿠키에요?	그냥 쿠키에요
이거 햄치즈는 얼마에요?	오천 원입니다
너무 뜨거워서 그런데 여기 얼음 세 개만 넣어주세요	네 넣어 드리겠습니다
로얄 밀크티는 뭐에요?	홍차에 티백 들어가는 음료입니다
커피가 들어갔나요?	아뇨 커피 안 들어가요
얼그레이는 홍차고 베리민트는 뭐에요?	베리민트도 홍차 들어가요
맛은 똑같은가요?	얼그레이는 얼그레이 맛이 나고 민트는 민트 맛이 납니다
솔티치즈 카페라떼 하나 줘요	따뜻한 걸로 드릴까요?
네 따뜻한 걸로 주세요	삼천오백 원이요
네 여기 뒤에 차 잠깐 세워도 돼요?	뒤쪽이 맘스터치 거라서 차 세우면 안 되세요 
차는 어디에 세워요?	가게 근처 빈자리에 세우시면 됩니다
여기 주차 단속은 안하나요?	네 단속 안합니다
커피 말고는 뭐 있어요?	라떼도 있고 주스도 있습니다
여기는 어떤 게 잘 나가요?	라떼는 곡물 라떼랑 고구마 라떼가 잘 나가고 주스는 블루베리와 아로니아가 잘 나갑니다
망고는 뭐에요?	망고는 시원해서 젊은 사람들이 선호합니다
블루베리도 잘 나가요?	네 블루베리도 잘 나가요
블루베리는 냉동 블루베리인가요?	네, 냉동 블루베리를 사용합니다
블루베리 주스 한 잔 주세요	네, 블루베르 주스 한 잔 준비해드릴게요
영수증 좀 주세요	네, 영수증 드리겠습니다
사장님 저 곡물 라떼는 뭐 들어가요?	곡물 라떼는 곡물 가루가 들어가고 우유 거품과 함께 따뜻하게 먹을 수 있습니다
블루베리 주스에는 시럽 들어가요?	네, 블루베르 주스에는 시럽이 들어갑니다
시럽 적당히 넣어주세요	네, 시럽 넣어드리겠습니다
냉동 블루베리에 시럽만 넣었나요?	블루베리 주스에는 시럽과 우유가 들어갔습니다
오늘은 몇 시까지 해요?	여섯시까지 합니다
카페라떼 많이 달아요?	카페라떼는 달지 않습니다
캬라멜 마끼아또는 달아요?	캬라멜 마끼아또는 단 음료입니다
카라멜 마끼아또도 시럽 빼면 괜찮을까요? 	카라멜 마끼아또는 시럽을 뺄 수는 없지만, 적게 넣을 수는 있습니다
케이크 종류도 있어요?	네, 케이크도 있습니다
티라미수는 어떤 거에요?	티라미수는 초콜렛과 치즈 맛이 나는 케이크입니다
티라미수는 많이 단가요?	네, 티라미수는 단 케이크입니다
생강 에이드도 많이 달아요?	네, 생강 에이드는 단 음료입니다
에이드가 차가운거죠?	에이드는 차갑게, 따뜻하게 모두 가능합니다
주차장은 없나봐요?	주차장은 가게 뒤에 있습니다
카페라떼는 설탕 빼주세요	네, 카페라떼에 설탕 빼드리겠습니다
오늘의 커피는 뭐에요?	오늘의 커피는 드립으로 내리는 커피에요
아메리카노하고 별 차이가 없어요?	아메리카노는 압력으로 추출하는 거라서 기름층이 있는데 오늘의 커피는 기름층 없이 부드럽게 드실 수 있어요 
오늘의 커피 연한 것도 가능해요?	오늘의 커피는 연하게 안 됩니다
오늘의 커피랑 아이스 아메리카노 주세요	오늘의 커피는 따뜻하게 드릴까요?
네 따뜻한 걸로 주세요	드시고 가세요?
네	사이즈 작은 걸로 두 잔 드리면 될까요?
작은 거 두 잔이 어느 정도에요?	왼쪽에 보시면 저희 컵 사이즈 예시가 나와있어요
제일 위에가 작은 거에요?	네 작은 거에요
작은 걸로 하고 충전도 할게요	충전 해서 결제 해드리면 될까요?
아뇨 충전만 5만원 해주세요	드시고 가시는거 맞으시죠?
먹다 남으면 포장 되나요?	네, 테이크아웃 잔에 옮겨 드려요
영수증 주세요	네 영수증, 오늘의 커피랑 아이스 아메리카노 준비해드리겠습니다
제일 작은 사이즈에요?	네, 가장 기본 사이즈고 따뜻한 건 한 단계 작은 사이즈가 또 있어요
빨대 주시고 물 한 컵 떠갈 수 있나요?	빨대와 물은 옆쪽에 보시면 준비되어 있습니다
차이티 라떼는 단 맛 조절이 가능해요?	네, 차이티 라떼는 단 맛 조절이 가능합니다
시럽이 조금만 들어가도 많이 달아요?	단 맛이 나기는 합니다
차이티 라떼 시키면 얼음물 주나요?	얼음은 따로 준비해 드릴 수 있습니다
이천햅쌀라떼가 뭐죠?	이천햅쌀라떼 파우더가 들어간 고소한 라떼라고 생각하시면 돼요
커피가 안 들어가는 거죠?	네 커피는 들어가지 않습니다
현금으로 결제를 하더라도 스타벅스 어플에 이력이 남나요?	스타벅스 카드 사용만 이력이 남습니다
카페 라떼하고 카페 모카하고 뭐가 달라요?	카페 라떼에는 우유만 들어가고, 카페 모카는 우유, 모카 소스가 들어가 단 맛이 나는 커피입니다
카페라떼 하나 주세요	드시고 가시나요?
텀블러 갖고 왔는데 할인 되나요?	텀블러는 삼백 원 할인 됩니다
텀블러에 담으려면 사이즈는 어떤 거 해야 돼요?	톨사이즈 입니다
톨사이즈가 제일 작은 건가요?	숏사이즈로 한 사이즈 더 작은 게 있습니다
톨사이즈로 주세요	네, 톨사이즈로 준비해드리겠습니다
샷은 한 개 들어가겠네요?	네, 톨사이즈는 샷이 한 개 들어갑니다
우유 양을 조금 더 많게 할 수 있나요?	거품 양을 조절해 우유 양을 조절 합니다
카드에 잔액이 남아 있나요?	잔액이 없습니다
충전해주세요	얼마 충전 해드릴까요?
삼만원이요	현금 영수증 드릴까요?
아뇨 설탕은 내가 따로 넣어야 돼요?	네 설탕은 직접 넣으셔야 됩니다
초콜릿 크림슈는 무슨 맛이에요?	초코맛 슈크림이 들어갑니다
잘 나가는 케이크가 어떤거죠?	조각케이크로요?
네 조각케이크로요	치즈케이크과 로얄비트쉬폰, 레드벨벳이 잘 나갑니다
뉴욕 치즈케이크 하나 주세요	포장이세요?
네 포장해주세요	오천칠백 원입니다
할인되는 카드 있어요?	현대엠포인트와 삼성포인트 신용카드, 씨제이원카드로 적립 가능하세요
씨제이 원카드라는건 뭐에요?	씨제이 계열사 포인트인데, 없으세요?
있어요 	실물카드나 바코드 있으시면 포인트 사용하시거나 적립 가능하세요
하나는 씨제이 원카드고 하나는 씨제이 계열 할인되는 국민 신용카드인데 두 개 다 사용 가능한가요?	네 씨제이 원카드, 국민카드 모두 사용 가능합니다
여긴 주차장이 따로 없죠?	야외 주차장과 주차 타워가 있습니다
포크 두 개 넣으셨나요?	네 포크 두 개 넣었습니다
화이트 초콜릿 모카랑 카페 모카랑 뭐가 달라요?	카페모카는 초코 소스가 들어가고, 화이트 초콜릿 모카는 좀 더 진한 화이트 초코 소스가 들어갑니다
소스가 더 끈적하다는 건가요?	네 초코 소스 보다 더 달은 소스 입니다
카페 라떼 하나 주세요	따뜻하게 톨사이즈로 드릴까요?
제일 작은 사이즈가 뭐죠?	숏사이즈 있어요
톨사이즈로 주세요	드시고 가세요?
아뇨 테이크아웃할게요	음료는 한 잔만 드릴까요?
네	사천 육백 원 결제하겠습니다
스타벅스 카드가 집에 많은데 별 적립한 걸 한 카드로 모을 수 있나요?	계정 등록하신 카드인가요?
잘 모르겠어요	확인해드릴게요
진열 된 건 모형이죠?	네, 진열 된 것들은 모형입니다
커피 음료 말고는 어떤게 있어요?	티, 라떼, 스파클링과 주스가 있습니다
자색 고구마는 어떤 맛이에요?	자색 고구마와 우유로 만든 음료입니다
초콜릿 라떼 하나 주세요	드시고 가세요?
아니요 일단 테이크아웃으로 주세요	네 4900원 입니다
할인되거나 적립되는 카드 없죠?	SK포인트 있으시면 사용 가능하세요
몇 퍼센트 되죠?	SK포인트는 15퍼센트 적용 가능합니다
주차는 어디다 하나요?	지정된 주차장은 없습니다
티멤버십 이 어플로 하면 되나요?	네 티멤버십 어플 맞습니다
지금까지 실물카드 계속 썼는데 왜 안되죠?	카드가 컴퓨터에 입력이 안되는 것 같습니다
영수증 좀 주세요	네 영수증 드리겠습니다
커피음료 말고는 어떤 게 있어요?	따뜻한거 찾으시나요?
네	밀크 베버리지나 블렌딩 드란티 종류로 보시면 됩니다
플랫치노에 적힌 초콜릿칩은 뭐에요?	플랫치노는 얼음이 들어가는 음료입니다
따뜻한 음료 중에 초콜렛은 없어요?	핫초코 있는데 드릴까요?
네 한 잔 주세요	휘핑크림 올려 드릴까요?
아니요	적립 하시겠어요?
아니요 	네 드시고 가시는 건가요?
일단 종이컵에 테이크아웃 해주세요 	매장 내에서는 일회용 컵 사용이 금지되어 있어서 양해 부탁드립니다
요거트는 플레인하고 딸기밖에 안돼요?	네 플레인 요거트와 딸기 요거트가 있습니다
그러면 플레인 요거트 하나 주시고 프라페는 뭐예요?	프라페는 얼음을 간 음료입니다
애들은 어떤 프라페를 좋아하나요?	아이들은 쿠키프라페를 많이 먹어요
플레인 요거트 하나랑 쿠키프라페 주세요	쿠키프라페에 휘핑크림 올려드릴까요?
네 휘핑 올려주세요	쿠폰 드릴까요?
네 전에 받은 쿠폰도 있어요	쿠폰 합쳐드릴게요
쿠폰 10개 모으면 음료 종류 상관없이 한 잔 무료예요?	아뇨 아메리카노 하나만 가능하세요
음료 안 쏟아지게 잘 포장해주세요	네 포장해드리겠습니다
이 음료에는 생딸기가 들어가요?	네 생딸기를 넣어요
에스프레소는 뜨거운 물 따로 주나요?	죄송합니다만 에스프레소는 불가능하고 2층 안쪽에 따로 레몬물이 준비되어 있습니다
라떼 중에서는 카페라떼가 제일 덜 달죠?	네 시럽이 안 들어가서 제일 안 달아요
카페라떼 하나 주세요	드시고 가세요?
네 2층에도 자리 있죠?	네 해피포인트 카드 있으세요?
네 여기요	적립 해드렸습니다
크림치즈 마카롱 한 개에 천 원인가요?	네 마카롱은 한 개당 천 원입니다
쿠앤크마카롱이랑 딸기마카롱도 하나씩 주세요	저희 매장 9시반까지 이용 가능하신데 괜찮으세요?
네 아이스 아메리카노도 하나 주세요	저희 마감 시간 다 돼서 테이크아웃컵에 제공해드릴게요
초코 마카롱이랑 요거트 마카롱도 하나씩 더 주세요	네 마카롱 총 다섯 개 구매하는 거 맞으시죠?
네 승차권 있으면 10프로 할인되나요?	네 승차권 있으시면 음료 10퍼센트 할인 가능합니다
영수증 하나 주세요	네 할인해서 7700원입니다
종이컵이랑 빨대 하나만 더 주면 안돼요?	종이컵과 빨대는 옆에 있습니다
커피 메뉴는 어디 있어요?	이쪽에 있어요
테이크아웃은 할인돼요?	네 테이크아웃하실 경우 할인됩니다
커피에 샷은 한 개 들어가나요?	아메리카노는 샷이 하나 들어가고 카페라테는 두 개 들어갑니다
커피인데 달콤하게 먹을 수 있는게 있나요?	바닐라라테를 추천드릴게요
바닐라라테에 바닐라가 들어간건가요?	바닐라 시럽이 들어가요
커피콘은 밀가루에 커피를 넣은 건가요?	네 와플같은 디저트입니다
커피콘 12개에 1500원짜리 테이크아웃이요	네 테이크아웃으로 해드리겠습니다
자스민차 있나요?	자스민차는 없어요
차 종류는 어디있나요?	차 종류는 저쪽 메뉴판을 보시면 돼요
아메리카노에 찬물을 조금 넣어주세요	네 드시고 가세요?
아뇨 테이크아웃 해주시고 10프로 할인해주시는거 맞나요?	아뇨 원래 아메리카노 2000원인데 1200원으로 해드리는 거예요
영수증도 좀 주실래요?	네 음료랑 같이 드릴게요
아메리카노에 찬물 넣으셨어요?	네 아메리카노에 찬물 조금 넣어드렸습니다
사장님 아메리카노가 뜨거워서 그러는데 얼음 몇 개 넣어주실 수 있어요?	네 얼음 드릴게요
테이크아웃하면 할인되나요?	아뇨 테이크아웃하셔도 가격은 같습니다
빵도 여기서 만드는 거예요?	네 1시되면 빵이 나와요
더치커피도 있어요?	네 더치커피 종류는 브라질 콜롬비아 에티오피아 세 가지 종류가 있어요
아메리카노 한 잔 주세요	따뜻한 걸로 드릴까요?
네 따뜻한 걸로 주세요	3800원 결제해드리겠습니다
더치커피는 작은 것도 팔아요?	더치커피는 앞에 있는 작은 것만 판매하고 있습니다
더치커피 얼마인데요?	4000원입니다
근처에 해룡이라는 중국집 있어요?	해룡은 조금 더 올라가셔야 해요
빵 시식 한 번 해봐도 돼요?	네 드셔보세요
커피 하나 주세요	아메리카노 맞으세요?
네 테이크아웃 할인돼요?	포장 할인은 안되세요
아메리카노 따뜻한거 하나 주세요	적립하실 전화번호 등록하신거 있으세요?
아뇨 적립은 몇퍼센트 되나요?	카드는 3퍼센트 현금은 5퍼센트 적립되시고 5000점부터 사용 가능합니다
전화번호만 말씀해드리면 돼요?	네 전화번호만 말씀해주세요
#전화번호#	성함이 어떻게 되세요?
#이름#	영수증 필요하세요?
네 포인트 적립됐어요?	네 영수증 밑에 보시면 포인트 적혀있어요
커피에 샷이 몇 개 들어가요?	따뜻한 아메리카노에는 샷이 한 개 들어갑니다
커피가 너무 뜨거운데 얼음 세 개만 넣어주세요	네 얼음 넣어드릴게요
2층도 있어요?	2층은 없어요
빵 시식할 수 있는 거 있어요?	네 시식은 저쪽에서 가능하세요
빨대는 어디 있나요?	카운터 밑에 보시면 납작한 빨대 있습니다 
밀크 캬라멜은 얼마예요?	밀크 캬라멜은 1200원이에요
혹시 빵 배달도 해주시나요?	배달은 안해요
명함 하나 가져가도 되죠?	네 명함 드리겠습니다
본점도 있어요?	저희 매장이 본점이에요
모과차 테이크아웃 되나요?	네 테이크아웃 가능하세요
혹시 모과차 두 잔으로 나눠줄 수 있어요?	두 잔 주문하시는 걸 추천드릴게요
모과차 한 잔하고 아메리카노 뜨거운 걸로 하나 주세요	드시고 가세요?
가져갈게요	테이크아웃 500원씩 할인되서 6500원입니다
영수증 주세요	네 영수증 드리겠습니다
음료 뜨겁지 않게 찬물 조금만 넣어주세요	네 찬물 넣어드리겠습니다
일요일에는 영업을 안하세요?	일요일 영업은 오후 6시에 마칩니다
쉬는 날은 없어요?	명절을 제외하고는 쉬는 날이 없습니다 
여기 더치커피 팔아요?	죄송합니다만 지금은 더치커피 재고가 없어요
아메리카노에 샷이 한 개에요?	네 아메리카노에는 샷이 한 개 들어갑니다
조금만 마시고 가도 되죠?	테이크아웃 할인해드려서 불가능합니다
커피가 1리터예요?	1리터도 가능하시고 작은 사이즈도 있어요
커피 가격이 1000원이에요?	네 1000원 맞아요
아메리카노 한 잔 주세요	따뜻한 걸로 드릴까요?  
네 따뜻한 걸로요	사이즈는요?
작은 걸로 주세요	드시고 가세요?
테이크아웃 해주시고 스탬프 적립돼요?	큰 사이즈만 스탬프 적립이 가능합니다
커피에 얼음 두 개만 넣어주실 수 있어요?	네 얼음 넣어드릴게요
여기 생긴지 얼마나 됐어요?	1년 넘었습니다
커피에 샷 한 개 들어간 거예요?	네 아메리카노에는 샷이 한 개 들어갑니다
사과는 얼마예요?	주스용이라 판매하고 있는 사과가 아닙니다
영수증 주세요	네 잠시만 기다려주세요 
메뉴판은 어디있어요?	메뉴판은 위와 옆쪽을 보시면 있습니다
커피 중에 우유는 안들어가는데 달콤한게 있나요?	아메리카노에 시럽 추가하시는 걸 추천드릴게요
카페모카에는 뭐가 들어갔죠?	카페모카에는 초코 시럽이 들어가 있어요
카페모카 위에 올라가 있는 건 우유 거품인가요?	우유 거품이 아닌 휘핑크림인데 빼실 수 있습니다
카페모카에 휘핑크림 올려주세요	따뜻한 걸로 드릴까요?
네 따뜻한 걸로 주세요	드시고 가세요?
아뇨 테이크아웃 해주시고 우유는 조금만 넣어주세요	우유를 덜 넣으면 맛이 진해지는데 괜찮으세요?
네 카페모카에 커피는 안들어가요?	카페모카에는 샷이 두 개 들어갑니다
영수증 주세요	네 테이크아웃하셔서 1000원 할인됐습니다
휘핑크림은 뭘로 만드나요?	휘핑크림에는 우유와 바닐라시럽이 들어갑니다
플랫화이트가 뭐예요?	우유 양이 적은 라떼입니다
여기 체인점이에요?	아뇨 개인 카페입니다
생긴지 얼마나 됐어요?	1년 넘었어요
포인트 적립도 하나요?	저희 매장에서 사용 가능한 쿠폰 드리겠습니다
따뜻한 아메리카노 작은 걸로 주세요	네 테이크아웃 할인 해드리겠습니다
더치커피도 판매 하나요?	죄송합니다만 더치커피는 없어요
영수증 주세요	네 영수증 드리겠습니다
원두는 갈아서 파시나요?	아뇨 원두는 안 팔고 있습니다 
컵 홀더 있나요?	네 컵에 홀더 끼워드릴게요
아메리카노에 샷이 두 개인가요?	네 아메리카노는 투 샷이에요
얼음 두 개만 넣어주세요	네 얼음 넣어드릴게요
케냐 에티오피아가 뭐예요?	매장에서 사용되는 원두입니다
더치 아메리카노는 아이스만 되죠?	아뇨 따뜻한 것도 됩니다
솔티드캬라멜라떼는 뭐예요?	솔티드캬라멜라떼는 시즌 메뉴 중 하나인데 약간 짭잘한 맛이 들어있는 커피입니다
구수한 맛이 혹시 들어있나요?	구수한 것보단 달달한 맛이 많이 나요 
더치라떼로 하나 주세요	따뜻한거 맞으세요?
네 따뜻한 걸로 주세요 	드시고 가는 거 맞으세요?
잠시만 여기 앉아서 마시다가 들고나가도 상관은 없죠?	오래만 앉아계시는거 아니면 괜찮아요 
테이크아웃컵을 실내에서는 사용 못하게 되어 있어요?	네 법적으로 불가능하게 되어있습니다
시럽은 어디있어요?	우측에 있어요
소금커피가 뭐예요?	아메리카노 위에 소금크림소스 올려드려요
단 맛은 안나는건가요?	심하게 짠 건 아니고 달면서 짜요
메이플라떼는 뭐예요?	메이플 시럽이 들어간 단 음료입니다
소금커피 한 번 먹어볼게요	따뜻한 걸로요?
네 따뜻한 걸로 주세요	가지고 가세요?
네 생긴지 얼마 안됐나봐요?	네 1월말에 개업했습니다 
리필도 해주나요?	네 샷 추가 가능하세요
마카롱은 3개에 6900원인가요?	네 맞습니다
대만샌드위치는 여기서 만든 거예요?	네 아침에 사장님이 만드시는 거예요
영수증 받아야 하는데 깜빡했네요	네 영수증 드릴게요
아메리카노 시원하게 하나 주세요	2000원입니다
더블에스프레소는 양이 두 배라는 말이에요?	샷을 원액으로 두 개 넣어드립니다
십구곡라떼는 뭐예요?	곡물라떼 곡물과 우유와 율무가 들어있어요
죄송한데 물 한 컵만 주세요	물은 뒤에 있어요
컵은 어디다 두면 돼요?	여기 주세요
가게가 10년이나 됐어요?	아뇨 저희는 2015년도에 개업했습니다
아포가토는 뭐예요?	저희는 아포카토는 없고 빽앤나가 있어요
빽앤나는 뭔데요?	커피 위에 아이스크림 올라가는 거예요
레몬에이드하고 티레몬에이드하고 어떻게 차이나나요?	티레몬에이드는 우려낸 차가 들어가서 차 맛이 좀 나요
콜드브루는 뭐예요?	더치커피를 시원하게 우려낸겁니다
콜드브루 시원하게 한 잔 주세요	3900원입니다
카드 되나요?	네 카드 결제됩니다 
모히토커피라떼는 뭐에요?	콜드브루에 모히토 티백을 넣어서 화한 맛과 달콤한 맛이 납니다
그냥 기본적인 콜드브루 하나 주세요	롯데 포인트 적립할까요?
아뇨 됐습니다	저희 적립 스탬프 찍어드릴까요?
네 히비스커스라즈 이거는 따뜻하게 나오나봐요	네 몸에 좋은 따뜻한 차예요
체인점인가봐요?	네 서울 경기 지역에 많이 있습니다
이 통은 뭔데요?	주스를 테이크아웃 주문하시는 분들에게 판매하고 있습니다
여기 매장은 국내 브랜드에요?	네 국내 브랜드 맞습니다
인삼한뿌리는 어떻게 만들어요?	인삼이랑 우유랑 시럽 조금 넣어서 만들어요
진저에이드는 아린 맛이 나나요?	네 그렇게 심하게 아리진 않아요
톨 사이즈가 제일 작은거예요?	네 톨 사이즈가 가장 작은 사이즈입니다
카푸치노 위에 시나몬 파우더 올라가나요?	시나몬 파우더는 셀프바에서 이용하시면 됩니다
아이스 아메리카노랑 카푸치노 한 잔씩 주세요	드시고 가세요?
네 먹고 가려고하는데 먹다가 남으면 테이크아웃 할 수 있나요?	네 테이크아웃 해드릴게요
여기는 자체 회원카드가 없나봐요?	저희 브랜드 어플 받으시면 회원카드 사용 가능합니다
혹시 리필도 되나요?	아메리카노 하신 거에 100원 추가하시면 돼요
따뜻한 물 좀 주세요	네 따뜻한 물 드릴게요
여기 와이파이 비밀번호가 어떻게 돼요?	와이파이 비밀번호는 영수증 밑에 적혀있습니다 
아메리카노 얼마예요?	3500원이요
주스 종류는 어떤게 있어요?	지금은 바나나 주스만 가능합니다
바나나 주스는 어떻게 만드는 거에요?	바나나 주스는 바나나랑 우유를 조금 넣어서 갈아드려요
바나나 주스 하나랑 아메리카노 하나 주세요	아메리카노 따뜻한 걸로 드릴까요?
네 따뜻한 걸로 주세요	드시고 가시나요?
네 병 주스는 어떤 게 있어요?	병 주스는 판매하지 않습니다
할인되는 카드는 없죠?	저희가 개인 카페라서 할인 카드는 따로 없어요
영수증 주세요	네 7800원입니다
쿠폰은 없어요?	쿠폰에 도장 찍어드릴게요
도장 10개까지 찍어야해요?	10번째까지 찍으시면 아메리카노랑 아이스티 한 잔 드려요
여기 화장실은 어디예요?	나가셔서 건물 바깥쪽에 있어요
주문을 잘못해서 그러는데 아이스로 해주시면 안돼요?	뜨거우시면 얼음 조금만 넣어드릴게요
지금 생과일 주스는 뭐가 돼요?	자몽 청포도 키위가 가능합니다
더치커피가 일반 커피보다 맛이 더 진한가요?	일반 커피와 비슷합니다
프라페는 뭐예요?	프라페는 얼음과 재료를 간 음료입니다
케냐AA보다 예가체프가 더 부드러워요?	네 가장 부드러운걸 찾으시면 마운틴을 추천드릴게요
블루마운틴 아메리카노 주세요	드시고 가세요?
네 먹고 갑니다	따뜻한 걸로 해드릴까요?
네 카드 되죠?	네 5000원입니다
구운 도너츠는 여기서 직접 굽는다 그랬죠?	네 저희가 직접 굽는 도너츠입니다
구운 도너츠 하나에 얼마예요?	작은 거 10개에 3천원입니다
모카치노가 뭐에요?	카페모카에 거품을 많이 넣어드리는 거예요
카페라떼 한 잔 주시겠어요?	드시고 가세요?
네 카페라떼 진하게 해주실 수 있으세요?	진하게 하시려면 샷을 추가하셔야 해요
여기 체인점인가요?	아뇨 저희는 체인점이 아닙니다
영수증 주세요	네 4000원 결제하겠습니다
여기 주차장이 따로 있어요?	주차장은 같은 건물에 있는 곳을 사용하시면 됩니다
와이파이 있어요?	네 비밀번호는 뒤쪽에 나와있어요
카카오페이 결제되나요?	네 카카오페이 가능합니다
휴대폰 급속 충전기 있어요?	급속 충전기는 없지만 주시면 저희가 충전해드릴 수 있어요
물티슈 하나 주세요	죄송합니다만 물티슈는 따로 없어요
따뜻한 물 한 잔 주실 수 있어요?	네 따뜻한 물 한 잔 드리겠습니다
제가 다 못마셔서 컵에 좀 옮겨주실 수 있나요?	네 테이크아웃잔에 옮겨드릴게요
휴지 조금 더 가져가도 되죠?	네 가능하세요
아메리카노 한 잔 주시겠어요?	따뜻한 거요?
네 따뜻한 걸로 주세요	1800원입니다
여기 혹시 쿠폰 있어요?	네 매장 쿠폰 있습니다
쿠폰은 10개 모으면 되는 건가요?	네 쿠폰 10개 모으시면 아메리카노 한 잔 드립니다
쿠폰으로 받는 커피는 따뜻한 아메리카노로 정해져있어요?	아이스로 변경하시는 건 상관 없어요
사장님 여기 혹시 주차는 어디 하면 되나요?	맞은편 빌딩에 대시면 1시간 무료 쿠폰이 나갈 거예요
주차단속 차가 다니나요?	네 저번 주부터 한 번씩 주차단속을 나와요
휴지말고 물티슈는 있어요?	죄송합니다만 물티슈는 따로 없습니다
커피에 얼음 두 개만 넣어주세요	네 넣어드릴게요
신데렐라 커피는 뭐예요?	원두를 선택하시는 커피예요
저는 좀 진한 거 좋아하는데 원두 추천해주세요	신 맛이 강한 건 어떠세요?
네 좋아해요	향이 진한 것도 괜찮으세요?
네 향이 진해도 상관 없어요	장화홍련이랑 바리스타마스터 추천드릴게요
제가 고른 원두로 아메리카노랑 라떼도 되는 거예요?	네 가능합니다
커피 코지코히는 뭐예요?	커피 코지코히는 드립커피입니다
코지코히는 900원이에요?	네 코지코히는 900원입니다
그럼 밀크코히는요?	밀크코히는 라떼입니다
메뉴를 일본어로 해 놓으신 거예요?	네 코히가 커피라는 뜻이에요
아메키라노 한 잔 주세요	드시고 가세요?
네 먹고 갈 거예요	네 아메리카노 한 잔 1900원입니다
가게 앞에 주차해도 되는 건가요?	가게 앞은 주차하시면 안 됩니다
그럼 어디에 주차하면 되나요?	옆에 있는 아파트 주차선에 주차하시면 됩니다
몇 시에서 몇 시까지 영업하세요?	저희는 8시부터 8시까지 영업합니다
네 휴지 좀 주시겠어요?	네 휴지 드리겠습니다
혹시 물티슈는 있나요?	네 물티슈도 드리겠습니다
마카롱도 같이 파시나요?	네 마카롱도 만들어서 팔고 있습니다
마카롱 한 개에 얼마예요?	마카롱 한 개는 1900원입니다
화장실은 어디로 가면 되나요?	화장실은 왼쪽으로 가시면 됩니다
마론마키야또는 무슨 맛이에요?	마론마키야또는 단 맛이 납니다
바닐라라떼는 어떤 게 들어가나요?	바닐라라떼에는 바닐라시럽이 들어갑니다
카페라떼 하나 주세요	드시고 가시나요?
네 먹고 갈 거예요	카페라떼 한 잔 4500원입니다
회원은 어떤 혜택이 있어요?	회원은 3프로씩 적립해 드립니다
회원 카드 하나 만들어 주세요	네 성함이랑 전화번호 적어 주세요
빵은 직접 다 만드시는 거예요?	네 직접 만들고 있습니다
오늘은 시식하는 게 없네요	네 오늘은 시식하는 게 없습니다
몇 시부터 몇 시까지 하시나요?	8시부터 11시까지 합니다
현금이나 카드나 똑같이 3프로 적립이 되는 거예요?	네 3프로씩 적립이 됩니다
음료 리필 서비스는 어떤 거예요?	음료 리필 서비스는 아메리카노랑 콜드브루 드시는 분들에게 해당됩니다
컵 홀더 하나 주세요	네 컵 홀더 하나 드리겠습니다
카카오페이 결제가 가능한가요?	카카오페이는 안 되고 삼성페이랑 엘지페이는 가능합니다
민트아메리카노는 어떤 거예요?	민트아메리카노는 지금 판매하지 않습니다
경성역 다방커피는 어떤 거예요?	경성역 다방커피는 연유커피입니다
라떼하고 비슷한 거예요?	돌체라떼와 비슷한데 라떼에 연유를 넣는 겁니다
더 고소한 맛이 많은 거예요?	부드러운 맛이 있습니다
그냥 아메리카노 한 잔 주세요	따뜻한 걸로 드릴까요?
네 따뜻한거 주세요	드시고 가시나요?
네 먹고 갈 거예요	20분 정도 걸리는데 괜찮으신가요?
네 혹시 적립카드 같은 게 있나요?	전화번호 말씀해 주시면 적립됩니다
적립은 어떻게 되나요?	적립은 쿠폰제로 10개 모으시면 음료 한 잔 드리는 방식입니다
카카오페이 결제는 되나요?	카카오페이는 불가능합니다
빵 종류는 뭐가 있나요?	지금은 허니버터볼, 치즈케이크, 브라우니만 가능합니다
카페에서 만드는 건가요?	브라우니랑 치즈케이크는 완제로 나오고 허니버터볼은 직접 만듭니다
와이파이 비번은 뭐예요?	와이파이 비밀번호는 카운터와 모니터에 적혀 있습니다
근처에 편의점이 어디 있어요?	편의점은 길 건너서 가셔야 합니다
빨대 있나요?	네 빨대 드리겠습니다
얼음 좀 넣어 주세요	네 얼음 넣어 드리겠습니다
그릇은 카운터에 반납하면 되나요?	네 그릇은 카운터로 주시면 됩니다
저녁 몇 시까지 하시나요?	저녁 7시까지 합니다
아포카토는 어떤 거예요?	아포카토는 바닐라 아이스크림에 에스프레소 샷이 들어가는 겁니다
스팀밀크는 어떤 거예요?	스팀밀크는 우유를 스팀으로 데워서 드리는 겁니다
아메리카노는 아이스랑 핫이랑 가격 차이 없어요?	네 아메리카노는 가격 차이가 없습니다
아메리카노 따뜻한 거 하나 주세요	네 적립 있으신가요?
적립 하나 만들어 주세요	네 전화번호 입력해 주세요
네 적립하면 어떤 혜택이 있나요?	결제금액에서 5프로씩 포인트 적립이 됩니다
현금이랑 카드랑 똑같아요?	네 적립은 똑같습니다
크루아상 빵도 만들어서 파시는 건가요?	네 크루아상도 만들어서 팔고 있습니다
크루아상 안에 초코나 생크림이 들어 있나요?	아뇨 크루아상 겉에 초코를 바른 겁니다
다른 빵은 없나요?	지금 다른 빵은 다 팔렸습니다
영수증 주시겠어요?	네 영수증 드리겠습니다
와이파이 비번 있나요?	와이파이 비밀번호는 따로 없습니다
화장실 어디예요?	화장실은 우측으로 가시면 됩니다
얼음 조금만 주시겠어요?	네 얼음 드리겠습니다
몇 시에서 몇 시까지 하시나요?	오전 10시부터 밤 12시까지합니다
머핀이랑 쿠키는 만들어서 파시는 건가요?	아뇨 머핀이랑 쿠키는 조달하는 제품입니다
헤이즐넛라떼는 뭐예요?	헤이즐넛라떼는 라떼에 헤이즐넛시럽이 들어가는 겁니다
더치라떼는요?	더치라떼는 찬물에 커피와 우유를 넣는 겁니다
치즈케이크라떼는 어떤 거예요?	치즈케이크라떼는 라떼에 치즈케이크 맛 파우더를 넣는 겁니다
커피에 들어가는 건가요?	아뇨 커피는 들어가지 않습니다
아메리카노 따뜻하게 한 잔 주세요	네 드시고 가시나요?
네 가지고 가는 거랑 가격이 같나요?	네 가격은 같습니다
카카오페이 결제도 되나요?	카카오페이 결제는 안 됩니다
영수증 주시겠어요?	네 영수증 드리겠습니다
몇 시까지 영업하시나요?	10시까지 영업합니다
할인쿠폰이나 적립카드 있나요?	저희는 할인쿠폰이나 적립카드가 없습니다
물은 어디서 마시면 돼요?	물은 좌측 정수기에서 드시면 됩니다
원두찌꺼기 주실 수 있나요?	네 원두찌꺼기 드리겠습니다
빨대도 하나 주시겠어요?	네 빨대 드리겠습니다
캐모마일은 어떤 거예요?	캐모마일은 허브티 티백입니다
숏라떼는 어떤 거예요?	숏라떼는 일반 라떼보다 진한 라떼입니다
양은 똑같아요?	숏라떼가 양은 좀 작지만 향이 깊고 진하게 드실 수 있습니다
카페라떼 따뜻한 거 레귤러로 한 잔 주세요	원두 두 가지 중 선택 가능하신데 어떤 걸로 드릴까요?
오리지날 블렌드로 주세요	네 카페라떼 한 잔 4600원 결제 도와드리겠습니다
카카오페이도 되는 건가요?	네 카카오페이 결제도 가능합니다
적립카드도 있어요?	CJ ONE 적립 가능합니다
CJ ONE은 어디서 등록하면 되나요?	CJ ONE 홈페이지에 보시면 나와 있습니다
적립된 건 바로 사용할 수 있어요?	포인트는 1000점부터 사용 가능하십니다
영수증 주시겠어요?	네 영수증 드리겠습니다
나눠 먹으려고 하는데 종이컵 좀 주실 수 있나요?	네 종이컵 드리겠습니다
몇 시에서 몇 시까지 영업하시나요?	9시부터 12시까지 영업합니다
빨대는 어디 있나요?	빨대는 좌측에 있습니다
얼그레이 아메리카노는 어떤 맛이에요?	기본 아메리카노에 얼그레이 티가 들어간 맛입니다
얼그레이는 뭐예요?	얼그레이는 홍차입니다
얼그레이 향이 좀 있겠네요?	네 얼그레이 향이 납니다
더블그린 카페라떼는 뭐예요?	더블그린 카페라떼는 녹차라떼라고 생각하시면 됩니다
일반 아메리카노로 주세요	아메리카노 차가운 걸로 드릴까요?
따뜻한 걸로 주세요	네 드시고 가시나요?
네 먹고 갈 거예요	시럽은 따로 필요없으세요?
네 시럽은 필요 없습니다	네 아메리카노 한 잔 3500원입니다
적립이나 할인카드 있나요?	공차 멤버십 있으시면 적립 가능하시고 SK 멤버십으로 할인 가능합니다
할인은 몇 프로 되나요?	할인은 등급에 따라 다릅니다
와이파이 비번 있나요?	와이파이 비밀번호는 영수증 하단에 적혀 있습니다
화장실은 어디 있어요?	화장실은 우측에 있습니다
휴지 조금 더 가져가도 되나요?	네 휴지 가져가셔도 됩니다
빨대랑 따뜻한 물 한 잔만 주세요	네 빨대랑 따뜻한 물 드리겠습니다
카카오페이나 삼성페이 결제가 가능한가요?	삼성페이는 가능합니다
화이트모카는 어떤 거예요?	화이트모카는 하얀 초콜릿이 들어간 음료입니다
캬라멜 마키야토는 단 거예요?	캬라멜 마키야토는 캬라멜 시럽이 들어가서 많이 답니다
커피잔도 판매하시는 거예요?	네 커피잔도 판매하고 있습니다
따뜻한 물 한 잔 주실래요?	네 따뜻한 물 한 잔 드리겠습니다
휴지 좀 주실래요?	네 휴지 드리겠습니다
리트로콜드브루는 따뜻한 거예요?	리트로콜드브루는 차가운 음료입니다
라떼 따뜻한 걸로 하나 주세요	사이즈는 레귤러와 라지 중에 뭘로 하시겠어요?
레귤러로 주세요	네 라떼 레귤러 사이즈 3800원입니다
포인트카드 되는 거 있어요?	해피포인트 적립 가능합니다
몇 프로 적립돼요?	해피포인트는 5프로 적립 가능합니다
현금이나 카드 똑같이 적립되는 거예요?	네 적립은 똑같습니다
여기 배달도 되나요?	네 배달은 배달의 민족 어플로 가능합니다
얼마 이상 주문해야 배달비가 무료예요?	3만원 이상으로 주문하셔야 배달비가 안 듭니다
얼음물은 어디서 마시면 돼요?	얼음물은 좌측에서 드시면 됩니다
여기 몇 시까지 영업해요?	저녁 열두 시까지 합니다
플랫치노는 뭐예요?	얼음이 들어간 차가운 음료입니다
스무디랑 비슷한 건가요?	네 스무디랑 비슷한 음료입니다
베이커리도 하시나 봐요?	케이크 종류는 팔고 있습니다
과일주스는 진짜 과일 갈아서 주는 거죠?	네 과일주스는 진짜 과일을 갈아서 드립니다
헤이즐넛 바닐라라떼 많이 달아요?	네 많이 답니다
혹시 설탕은 없어요?	설탕 있습니다
도장은 몇 개 찍어야 하나요?	도장 일곱 개 찍으시면 음료 한 잔 드립니다
시나몬 뿌려주는 거 있나요?	카푸치노에 시나몬이 들어갑니다
카푸치노 한 잔 주세요	네 카푸치노 한 잔 3500원입니다
영수증도 주세요	네 영수증 드리겠습니다
쿠폰 있으면 하나 만들어 주세요	네 쿠폰 드리겠습니다
아홉 잔 마시면 열 번째는 서비스인가요?	네 서비스는 아메리카노만 가능합니다
달지 않은 따뜻한 음료 뭐가 괜찮나요?	카푸치노랑 카페라떼는 시럽이 안 들어갑니다
카페라떼 한 잔 주세요	네 카페라떼 한 잔 3600원입니다
영수증도 주세요	네 영수증 드리겠습니다
화장실은 어디 있어요?	화장실은 밖으로 나가서 왼쪽에 있습니다
어떤 음료가 잘 나가나요?	어떤 종류 찾으시나요?
커피 종류요	아메리카노가 제일 잘 나갑니다
아메리카노 R사이즈 하나 주세요	따뜻하게 드릴까요?
네 따뜻하게 주세요	네 따뜻한 아메리카노 한 잔 3200원입니다
영수증 하나 주세요	네 영수증 하나 드리겠습니다
빨대는 어디 있어요?	빨대는 좌측에 준비되어 있습니다
아이스 아메리카노 한 잔 주세요	드시고 가시는 건가요?
네 그린티 라떼는 녹차가루 들어가는 건가요?	네 그린티 라떼에는 녹차 파우더가 들어갑니다
요거트 스무디 하나랑 딸기 스무디 그리고 아이스 아메리카노 주세요	총 세 잔 맞으신가요?
네 스탬프도 하나 만들어 주세요	네 번호 입력해 주세요
영수증도 하나 주세요	네 영수증 드리겠습니다
요거트 덜어 먹을 그릇 하나만 주세요	저희는 따로 그릇이 없습니다
그럼 종이컵 하나만 주세요	네 종이컵 하나 드리겠습니다
어떤 음료가 제일 잘 나가요?	휘핑크림 카푸치노가 제일 잘 나갑니다
카페라떼 한 잔 주세요	네 카페라떼 한 잔 드리겠습니다
카페라떼에 샷이 몇 개가 들어가요?	카페라떼에는 샷 세 개가 들어갑니다
하나 반 정도만 넣을 수 있나요?	네 샷 하나 반만 넣어 드리겠습니다
원사이즈인가요?	네 저희 음료는 원사이즈입니다
시럽은 조금만 넣어 주세요	네 시럽은 조금만 넣어 드리겠습니다
커피 말고 다른 메뉴는 뭐가 있나요?	티나 에이드 종류가 있습니다
스무디는 차가운 거죠?	네 스무디는 차가운 음료입니다
초콜렛 라떼는 초콜렛맛이죠?	네 초콜렛 라떼는 초콜렛맛입니다
초콜렛 라떼 하나 주세요	따뜻한 걸로 드릴까요?
네 따뜻한 걸로 주세요	네 따뜻한 초콜렛 라떼 2900원입니다
초콜렛 라떼 많이 달아요?	네 초콜렛 라떼는 많이 답니다
적립 안 되나요?	저희는 적립 말고 쿠폰이 있습니다
콜드폼 카푸치노가 뭐예요?	콜드폼 카푸치노는 카푸치노 위에 폼이 올라가는 겁니다
카페라떼 하나 주세요	카페라떼 따뜻한 걸로 드릴까요?
네 따뜻한 걸로	드시고 가실 건가요?
테이크아웃 할게요	네 카페라떼 한 잔 4600원입니다
영수증 주세요	현금영수증으로 해 드릴까요?
아뇨 그냥 일반 영수증으로 주세요	네 일반 영수증 드리겠습니다
화장실 어디 있어요?	화장실은 2층에 있습니다
시럽은 어디 있나요?	시럽은 좌측에 준비되어 있습니다
쵸코 음료는 어떤 게 있어요?	쵸코는 아이스초코, 핫초코랑 자바 칩 음료 있습니다
시그니처 초콜렛 같은 건 없어요?	시그니처 초콜렛도 있습니다
시그니처 초콜렛으로 한 잔 주세요	따뜻한 걸로 드릴까요?
시원한 걸로 주세요	사이즈는 어떻게 드릴까요?
톨 사이즈로 주세요	드시고 가시나요?
아뇨 가지고 갈게요	휘핑 크림 올라가는데 괜찮으세요?
아뇨 빼 주세요	네 시그니처 초콜렛 한 잔 4300원입니다
주차장은 따로 없나요?	네 주차장은 따로 없습니다
일반 영수증 하나 주세요	네 영수증 드리겠습니다
제일 잘 나가는 생크림 케이크가 어떤 건가요?	찾으시는 특징이 있으신가요?
밑에 슈크림이 들어갔다고 하던데	네 그럼 생크림 카스텔라가 제일 잘 나갑니다
일단 생크림 카스텔라 주세요	네 생크림 카스텔라 하나 결제 도와드리겠습니다
할인 되는 카드가 따로 있나요?	KT나 LG유플러스 카드 할인 가능합니다
물티슈도 좀 주시겠어요?	네 물티슈도 드리겠습니다
내일 먹을 경우에는 어떻게 보관해야 해요?	냉장보관 하시면 됩니다
오늘의 커피라는 게 뭐예요?	오늘의 커피는 베란다라는 드립커피예요
이거는 맛 괜찮아요?	평소에 어떤 커피를 주로 드시나요?
아메리카노요	그럼 베란다 같은 경우 조금 연하게 느껴지실 수 있습니다
연해도 괜찮으니 숏 사이즈로 주세요	네 드시고 가시는 건가요?
네 먹고 갑니다	현금영수증 필요하신가요?
일반 영수증으로 주세요	네 일반 영수증으로 드리겠습니다
시럽 넣어 주나요?	시럽은 직접 넣으시면 됩니다
테이크아웃 되죠?	네 테이크아웃 됩니다
카페라떼 하나 주세요	따뜻하게 해드려요?
네 따뜻하게 해주세요	3천원 결제 도와드리겠습니다
여기 주차 잠깐 해놔도 돼요?	네 가능합니다
테이크아웃은 다 할인 되는거에요?	아메리카노 라떼 바닐라까지만 할인돼요
얼마 할인 되는거죠?	원래 4500원인데 3000원으로 할인되는거에요
시럽 한 번만 넣어주세요	네 넣어드리겠습니다
사이즈는 따로 없나봐요	네 한가지밖에 없어요
커피음료 말고는 어떤거 있어요?	따뜻한거 찾으세요?
상관 없어요	주스나 차 뿐만 아니라 다양한 메뉴가 있습니다
주스류는 어떤게 있어요?	토마토 자몽 오렌지가 있습니다
생과일인가요 냉동과일인가요?	생과일입니다
토마토 주스 하나 주세요	드시고 가시나요?
네 마시고 갑니다	해피포인트 적립이나 저희 매장 쿠폰 갖고 있는거 있으세요?
할인되는 카드도 있어요?	음료 한잔 구매하시면 아메리카노 교환 쿠폰 있는데 2월 말까지 쓰시면 돼요
네 여기 와이파이 돼요?	영수증에 비밀번호 나와있습니다
저기 주스 좀 기다려야돼요?	네 조금 기다려야합니다
화장실좀 갔다올게요	네 금방 해드리겠습니다
스타벅스 돌체라떼는 어떤거에요?	샷이랑 우유랑 돌체 소스라는 원유가 들어간 달달한 커피입니다
많이 달겠네요?	많이 달아요
아메리카노 하나 주세요	아메리카노 따뜻하게 드릴까요?
네 사이즈가 숏사이즈 톨사이즈 이렇게 있어요?	숏사이즈는 제일 작은 사이즈이고 기본이 톨사이즈 그다음 그란데 제일 큰 벤티 이렇게 있어요
숏사이즈로 주세요	숏사이즈 많이 작은데 괜찮으세요?
네 괜찮아요	숏사이즈는 따뜻한것만 가능합니다
네 상관 없어요	가져가시나요?
네 테이크아웃이요	더 필요한건 없으세요?
없어요	네 3600원이고 현금영수증 가능하신데 입력 해드릴까요?
네 현금영수증 입력 해주세요	번호 한 번만 입력해주시겠어요?
알겠습니다	결제다되셨구요 번호불러드리겠습니다.
영수증 좀 주세요	뽑아 드릴까요?
네 얼마나 기다려야 돼요?	2분 정도만 기다려주세요
저게 다 커피 음료에요?	커피음료있고 여긴 커피 아닌거에요
카페 모카하고 카라멜 모카는 뭐가 달라요?	카라멜은 카라멜이 더 추가되는 겁니다
조금 더 달겠네요	카페 모카보다 더 달아요
아메리카노 하나 주세요	사이즈는 어떻게 하시죠?
레귤러랑 톨사이즈 있네요	네 두개 있습니다
톨 사이즈면 몇미리죠?	저희가 16온스로 계산을 하는데 이게 레귤러고 이게 톨입니다
톨로 주세요	드시고 가세요?
아니요 마시고가려고요	커피음료 가져가시는거 저희가 할인해드리는게 있어요
커피음료는 무조건 할인해주시는거에요?	커피는 할인해드려요
시럽 조금만 넣어주세요	조금만 넣어드리겠습니다
조금 달달한건 어떤거 있어요?	녹차라떼라고 연유 들어간거 있구요 바날라라떼 모카라떼 카라멜 마끼야또 아니면 초콜렛 들어가는 초콜렛 모카랑 카페모카있습니다
돌체라떼는 많이 단가요?	연유 들어가는거라서 달아요
돌체라뗴 하나 주세요	따뜻하게 드릴까요
아이스로 주세요	사이즈는 어떻게 하시겠어요?
사이즈 뭐뭐 있나요?	톨 그란데 벤티 이렇게 있어요
그란데 사이즈로 주세요	드시고 가세요?
아뇨 테이크아웃이요	더 필요하신거 있으세요?
괜찮습니다	5100원입니다
영수증 좀 주세요	현금영수증 해드릴까요
아뇨 일반 영수증 주세요	네 주문번호 불러드릴게요
돌체라떼 금방 되죠?	네 금방 됩니다
컵홀더 어디있나요	오른쪽에 있습니다
커피음료 말고는 뭐 있어요?	커피음료 말고는 티 음료랑 생과일 주스 있어요
메뉴판에 있는 주스 다 되는거에요?	전부 가능합니다
토마토 주스 생과일인가요?	냉동과일아니고 생과일입니다
토마토 주스 하나 주세요	네 3천원 결제 도와드릴게요
한잔 사면 쿠폰 있다고 하던데요?	네 있습니다
쿠폰으로는 뭐 가능하죠	커피종류 드실수 있습니다
아메리카노 하나주세요	따뜻한걸로 드려요?
네 주스는 여기서 마시고 커피는 테이크아웃 해주세요	네 준비되면 진동벨로 알려드릴게요
저녁에는 몇 시까지 영업해요?	열 시까지 영업합니다
커피는 너무 달지않게 시럽조금만 넣어주세요	네 조금만 넣어드릴게요
커피는 뭐가 맛잇어요?	커피는 어떤 종류드세요?
많이 단거 싫어하고 쓴것도 싫어해요	시럽 조금 들어가는거 좋으시면 바닐라라떼나 헤이즐넛라떼하시면 돼요
초코라떼에도 우유 들어가는거에요?	초코라떼는 초코라떼 원액을 만들어두고 우유에다가 시럽 들어가서 만들어드리는거에요
초코라떼 하나 주세요	드시고 가세요?
네 먹고 가요	저희 레귤러랑 라지 있는데 어느걸로 드릴까요?
레귤러는 몇 미리고 라지는 몇 미리에요?	이정도가 레귤러 사이즈입니다
레귤러로 주세요	따뜻한거랑 차가운거 있는데 어느걸로 드릴까요?
따뜻한걸로 주세요	초코라떼 레귤러 사이즈 따뜻한걸로 테이크아웃하시는거 맞으세요?
네 맞습니다	3500원이고 영수증 드릴까요?
네 주세요	휘핑 얹어드릴까요?
안 얹어도 될것 같아요	초코시럽 들어가는데 초코시럽은 어떻게 해드릴까요?
위에 조금만 뿌려주세요	네 알겠습니다
커피 어떤게 맛있어요 	더치 잘나가고 단거 좋아하시면 카라멜 라떼도 괜찮습니다
더치커피는 그냥 아메리카노 처럼 돼있나요?	일반 아메리카노보다는 조금 더 연해요 
더치 하나 주세요	아이스로 드시는거세요? 
따뜻한걸로 주세요 	드시고 가세요? 
아니요 테이크아웃해주시고 테이크아웃하면 할인되는거 없어요?	청운신협에 체크카드로 결제하시면 20%할인되는건 있어요 
영수증 주시고 시럽 조금넣어주세요	네 잠시만 기다려주세요
물티슈 있어요?	엘리베이터 옆에 보시면 휴지랑 다 있어요
카페 비엔나는 어떤거에요? 	아메리카노에 휘핑 들어간거에요
아포카도는요?	아이스크림 올라간거에요
카페라떼 아이스로 하나 주시고 사이즈 있나요?	사이즈는 따로 없어요 
네 테이크아웃 해주시고 얼음은 조금만 넣어주세요	샷은 하나만 들어가는데 더 넣어드릴까요?
아니요 시럽 좀 넣어주시고 영수증 주세요	네 잠시만 기다려주세요
여기 주차장은 앞쪽 밖에 없어요 ?	뒤에도 있습니다
카페라떼 사이즈 있나요?	저희 다 빅사이즈에요 
카페라떼 시럽 좀 넣어서 아이스로 해주세요 	시럽 어느정도 넣어드릴까요?
두 번 넣어주세요	2500원입니다
여기는 몇 시에 문열어요 ?	8시요
저녁에 몇 시까지 해요 	11시요 
카페 모카는 어떤거에요 	초코가 들어가는거에요
영수증 주세요	네 여기 있습니다
더치커피는 좀 연한가요 	더치커피는 카페라떼랑 시원한 향이 납니다
더치커피로 하나주세요	더치커피 2800원이고 아이스로 드릴까요?
네 얼음 너무 많이 넣진 말아주세요	드시고 가세요 ?
아뇨 테이크아웃이요	테이크아웃잔 준비해드릴게요 
여긴 테이크아웃잔 하면 할인해주는거 없어요?	아메리카노만 할인 해드립니다
얼마 할인되는데요? 	원래 3500원인데 테이크아웃은 2500원이에요
그냥 더치커피로해서 영수증 주세요 	네 금방 해드리겠습니다
시럽 좀 넘어주세요 	얼마나 넣어드릴까요?
두펌프 해주세요	네 두펌프 해드리겠습니다
아메리카노 레귤러보다 더 작은건 없나요?	네 레귤러가 제일 작은거에요
레귤러 사이즈로 아메리카노 한잔 주세요	네 드시고 가세요?
테이크 아웃으로주세요	따뜻하게 해드려요?
네 따뜻하게 해주세요	진하게 할까요?
진하게하면 샷이 얼마나 들어가요?	투샷 들어가요
원래는 얼마나 들어가죠?	원래는 한샷 반 들어갑니다
원래대로 해주시고 카드로 할게요	KT있으면 할인됩니다
KT아닌데 다른거 적립은 없나요?	오케이 캐쉬백 포인트 차감 되고 다른건 없습니다
네 영수증 좀 주세요	네 잠시만 기다려주세요
화장실이 안에 있나요?	밖에 있습니다
영업시간이 얼마나 되죠?	오전10시부터 오후10시까지 합니다
조금 뜨거워서 그런데 얼음 한 개만 넣어주실 수 있나요?	네 넣어드리겠습니다
아이스크림도 많이 파나봐요?	네 밑에있는건 아이스크림이고 위에 있는건 베이글 안에 들어가는 크림치즈입니다
밀크폼 아메리카노가 뭐에요?	아메리카노 위에 우유거품 올라간거에요
아이스로 나온거에요?	아이스도 있고 따뜻한 것도 있습니다
아메리카노로 주시고 사이즈 따로 있나요?	사이즈는 하나고 기본 샷은 두 개가 들어갑니다
따뜻하게 해주세요	네 시럽 넣어드릴까요?
아니요 시럽 없이 해주세요	공차 적립하시나요?
아니요 적립 안해요	3000원 결제 도와드리겠습니다
영수증 주세요	네 여기있습니다
학생들 마실 수 있는거 있어요?	종류가 다양하게 있는데 학생분들은 주스쪽 많이 마셔요
생과일 주스에요?	냉동과일 아니고 생과일입니다
코코아는 얼마에요?	사천원입니다
코코아는 맛있어요?	단거 좋아하시면 맛있어요
딸기하고 바나나 섞은거 맛있나요?	많이 드십니다
딸기하고 바나나 있는건 얼마에요?	사천원이요
딸기 바나나 섞은거 한잔 주세요	드시고 가시는 거에요?
네 따뜻한거 마시고 싶은데 학생들 먹을거 코코아 말곤 없죠?	메뉴를 어떤 종류로 찾으시나요?
학생들 먹을게 코코아밖에 생각이 안나는데 다른거 있나요?	티도 있고 고구마 라떼도있고 청으로담은 에이드도 있습니다
어떤 에이드요?	유자에이드 레몬에이드 자몽에이드 있습니다
따뜻한 물 한잔도 주실래요?	네 드릴게요
밀크티는 홍차에다가 우유 넣은거 아니에요?	우유에 넣은게 아니고 저희는 대만에서 갖고온 비싼 음료갖고 파우더를 넣은겁니다
어떤 파우더에요?	밀크 파우더요
잘팔리는게 실론 밀크티에요?	가장 기본적인 블랙 밀크티구요 다른거 드시던 분들은 타이거 밀크 제품 많이 드세요
타이거 밀크티 달아요?	네 타이거 밀크티는 달아요
왜 타이거 밀크티에요?	저희가 슈가를 둘러드리는데 이게 나중에 호랑이 무늬처럼 흘러내려서 그렇습니다
뜨거운 것도 이렇게 되나요?	타이거 밀크티는 뜨거운게 안나오고 기본적인 실론 밀크티는 따뜻한 것도 가능합니다
이층도 있나요?	네 이층도 있습니다
영업한지 얼마나 됐어요?	6개월 정도 됐습니다
화장실은 어디있어요?	나가셔서 옆 상가 화장실 이용하시면돼요
아메리카노 한잔 주세요	테이크아웃 하실거에요?
테이크아웃은 더 싸요?	가격은 똑같이 이천 원입니다
수제 누가 크래커도 있네요?	네 재료를 대만에서 가지고 와서 만들었습니다
커피 나왔나요?	잠시 기다려주세요
초콜렛 같은 음료는 뭡니까?	초코라떼입니다
종이 스트로우 있나요?	그거는 스타벅스에서만 시행합니다
조금만 마시다 가도 되죠?	네 괜찮습니다
메뉴는 많지는 않네요?	네 저희는 아무래도 대만에서 그대로 갖고 오기 때문에 그렇게 많은 메뉴를 운영하지는 않습니다
주 고객층은 그러면 젊은 사람들 많죠?	저희는 다양해요
빨대 하나만 가져갈게요	네 여기있습니다
드립 커피는 시간이 조금 걸리죠?	드립 커피 하는데 그렇게 많이 안 걸려요
양이 너무 많은데 저 이제 식사하고 와서 커피 메뉴판은 어디 있나요?	메뉴판은 앞에 있고, 커피 말고 차도 있어요
저는 뜨겁게 쟈스민 차 주세요	머그컵에 드릴까요?
테이크 아웃으로 해주세요	네, 테이크 아웃 잔에 준비해드릴게요
결제는 카카오페이, 삼성페이 이런 것도 되요?	네, 카카오페이, 삼성페이 모두 됩니다
카페 이름이 1분이에요?	네, 카페 1분입니다
마카롱 컬러만 다른가 맛볼 수 있어요?	시식할 수 없습니다
색소는 뭐 써요?	식용 색소 사용합니다
갑자기 먹고 싶어지는데, 마카롱 주세요	영수증 챙겨드릴까요?
네, 이천 원이죠?	네, 이천 원입니다
1분 커피가 어떤 거에요?	카페라테에 초코칩 아이스크림 올라갑니다
쉬는 날은 있어요?	쉬는 날은 정해져 있지 않습니다
화장실은 어디 있어요?	화장실은 출입구 옆에 있습니다
아메리카노 위에 커피 하얀 거 얹는 게 뭐죠?	휘핑크림이요
휘핑크림 말고 다른 건 또 뭐 있어요?	휘핑크림 밖에 없습니다
커피 위에 올라가는 거 하얀색이 휘핑크림, 우유 외에 다른 건 없나요?	아메리카노에는 보통 크림을 안 올리고 드세요
아메리카노에는 안 올린다구요?	네, 모카에 휘핑크림이 올라가고, 다른 크림이 있긴 하지만 여기서는 판매하지 않습니다
이름이 뭐라구요?	초코시럽이 들어가는 카페모카요
모카인데 크림이 흰색이에요?	네, 모카는 휘핑크림이 올라가는데 빼드릴 수도 있어요
도피오가 뭡니까?	에스프레소 더블 샷입니다
아메리카노 테이크 아웃 할인되나요?	할인 안 됩니다
아메리카노 테이크 아웃으로 해주세요	뜨거운 걸로 드릴까요?
네, 근데 컵에서 마실 때랑 맛이 다른 거 같은데 샷이 몇 개에요?	따뜻한 경우는 한 샷, 아이스는 더블 샷 들어갑니다
뜨거워서 그러는데 얼음 두 개만 넣어주실래요?	네, 얼음은 오른쪽에 있습니다
결제는 삼성페이, 카카오페이 이런 것도 다 돼요?	네, 삼성페이, 카카오페이 전부 가능합니다
생과일 뭐가 있어요?	딸기, 키위, 망고, 바나나, 블루베리 있습니다
딸기는 몇 프로 들어가요?	딸기 많이 들어가고, 직접 만든 딸기잼도 들어갑니다
잼이 들어간다고요?	네, 스무디에 딸기 90프로, 딸기잼 10프로 들어가요
메뉴에 딸기 어디 있죠?	딸기는 계절과일이라고 있어요
작은 사이즈도 있나요?	원 사이즈에요
얼음을 빼주세요	드시고 가시는 거예요?
테이크 아웃은 천 원 할인돼요?	네, 테이크 아웃은 천 원 할인됩니다
적립도 되고 그래요?	쿠폰으로 적립할 수 있습니다
제가 오늘 설탕 섭취를 많이 해서 잼을 안 넣으면 어떻게 될까요?	잼을 안 넣으면 조금 싱거울 수 있어요
딸기 100프로에요?	네, 딸기 100프로입니다
너무 찐해서 그러는데 미지근한 물 좀 넣어 주세요	네, 물 넣어드릴게요
커피 코너에서 달지 않은 거는 아메리카노 밖에 없나요	달지 않은 커피 중에 우유가 들어간 카페라테도 있어요
허브차는 어떤 거	허브차 종류는 여기 있습니다
히비스커스라는 식물 이름이 있어요?	네, 루이보스, 히비스커스, 레몬밤 모두 허브 종류이고, 그 종류 별로 허브차가 나와요
저 카모마일 한 잔 따뜻하게 주세요	드시고 가실 거예요?
네, 먹고 갈 거예요	영수증 드릴까요?
네, 화장실은 어디 있습니까?	엘리베이터 옆에 있고, 키 갖고 가세요
요즘 뭐 잘나가요?	차 같은 경우는 참귤하고 자몽이 제일 잘나가요
니트로 커피는 뭐예요?	니트로는 에스프레소인데 콜드브루 베이스라고 해서 천천히 내려서 냉장 추출한 것을 가스통에 질소를 넣고 만들면 거품도 나고 맥주처럼 부드러워요
니트로 커피 하나랑 그러면 에스프레소 하나 이렇게 두 개 주시고, 여기는 적립 뭐 돼요?	이디야로 적립 됩니다
할인 그런 거는 없고, 오로지 그냥 적립 그것만 되는 거예요?	적립이랑 쿠폰 있고, 회원들한테 주는 할인 쿠폰있는데 실버, 패밀리, 골드, VIP 단계가 있고, 새로운 상품이 나오면 쿠폰 드려요
회원들한테?	네, 회원들한테는 5프로, 10프로 같은 할인 쿠폰도 하나 드려요
골드에서 VIP가 되려면 얼마나 먹어야지 그렇게 돼요	단계별로 쿠폰을 몇 개 더 적립해야 되는지 나오는데 그걸로 확인할 수 있어요
영수증 안 받았죠?	네 영수증 드리겠습니다
블루베리 주스 맛있다고 그러던데	지금은 블루베리 주스 안 돼요
뭐 돼요?	아메리카노만 돼요
아메리카노 한 잔, 테이크 아웃 해주세요	네, 테이크 아웃 잔에 준비해드리겠습니다
생크림이 고체가 있고, 액체도 있나요?	액체 생크림은 없어요
원래 있기는 있어요?	액체 생크림은 카페마다 달라요
테이크 아웃 할인은 돼요?	테이크 아웃 할인 안 됩니다
아이스크림은 어디에 있어요?	아이스크림은 여기 있는 게 전부이고, 삼천 오백 원이에요
바닐라 컵으로 하나 주시고, 사이즈는 없죠?	크기는 작은 사이즈 밖에 없는데 바닐라로 하나 드릴까요?
네, 하나 주세요	홈플러스 적립 하시겠어요?
홈플러스에서 하는데 아니지 않아요?	홈플러스 마트 안에 있으니까 적립 가능하시고, 도장 찍는 쿠폰 하나 드릴까요?
네, 쿠폰 주세요	네, 쿠폰 드리겠습니다
생크림 카스텔라 포장 되요?	생크림 카스텔라 낱개 포장 가능하세요
하나만 포장해주세요	포크 몇 개 넣어드릴까요?
포크는 안 주셔도 돼요	사천 오백 원 결제 도와드릴게요
네, 주차는 여기 타워에 해도 되요?	네, 두 시간 무료 가능하니까 주차증 주시면 찍어 드릴게요
블루베리 쿠키치즈 케이크 이거는 뭐 들었어요?	안에 진하고 좀 꾸덕꾸덕한 치즈케이크 들었어요
카카오페이나 삼성페이 결제돼요?	네, 카카오페이, 삼성페이 모두 가능합니다
마카롱 하나에 이천 오백 원인 거예요?	네, 이천 오백 원입니다
텀블러 가져오면 커피 할인되는 거 있어요?	삼백 원 할인됩니다
아메리카노 따뜻하게 한 잔주세요	드시고 가시는 거예요?
가져갈 건데 콜드브루는 시원한 거만 되죠?	아이스만 됩니다
네, 텀블러에 좀 담아주세요	삼천 팔백 원 입니다
네, 마샬라차이 저거는 뭐에요?	마샬라차이는 약간 생강향 나는 음료입니다
생강향 나고 좀 달달하죠?	시럽이 한 번 들어가는데 엄청 달지는 않아요
적립되는 건 없어요?	CJ포인트 있으세요?
CJ포인트 있어요	번호 입력해주세요
네, 입력했습니다	적립해드렸고, 앞에 계시면 바로 해드릴게요
포인트 결제하는 거는 CJ포인트 밖에 없나 봐요?	삼성카드나 현대M 카드도 포인트 있으면 사용 가능합니다
물 한 잔만 먹으려고 하는데 물 어디 있어요?	물은 이쪽에 종이컵이랑 같이 있어요
시럽은 어디 있나요?	시럽은 저쪽에 있습니다
텀블러 저것도 CJ포인트로 살 수 있어요?	CJ포인트가 이만 점 이상 있으면 가능합니다
아메리카노 한 잔 따뜻하게 해서 주시고, 와플 이런 거는 포장 안 되죠?	플레인 와플만 포장 됩니다
아메리카노 따뜻한 걸로 주세요	드시고 가세요?
가지고 갈 거예요	적립할 L포인트 있으세요?
아니요, 롯데상품권으로 결제할 수 있나요?	롯데 상품권으로 결제 불가능 합니다
영수증 주시고, 여기 주차는 어디에 해요?	주차는 주변 건물 주차장 이용하시면 돼요
스위트 팬케이크 이거 안에 뭐 들었어요?	팬케이크 안에는 아무것도 없고, 커스터드 크림이랑 같이 준비해드립니다
베리 케이크랑 크림이 다르다는 거죠?	베리 케이크는 블루베리랑 라즈베리 같이 준비해드립니다
두 개에 오천 팔백 원 아니면 한 개에 오천 팔백 원이에요?	두 개에 오천 팔백 원입니다
단체 여섯 명에서 일곱 명 오고 하면 따로 할인 안 되죠?	네, 할인 안 됩니다
콜드 폼 카푸치노는 뭐에요?	콜드 폼 카푸치노는 위에 차가운 폼이 올라가서 아이스만 가능한 음료인데 따뜻한 거 원하시는 거예요?
아니요, 아이스요	콜드 폼 카푸치노는 샷이 좀 진하게 들어가고 위에 쫀득한 폼 올라가서 괜찮아요
좀 달작한거죠?	네, 달달한 건데 원하시면 안에 들어가는 시럽 뺄 수도 있어요
아이스 아메리카노 한 잔 주세요	가져가실 거예요?
네, 가져갈게요	카드 앞쪽에 꽂아주세요
여기 매장에서 먹다가 남으면 혹시 테이크 아웃 해줘요?	테이크 아웃 잔에 넣어드립니다
마카롱이 한 개당 이천 칠백 원인 거예요?	네, 한 개당 이천 칠백 원입니다
치즈케이크 포장도 해줘요?	네, 포장됩니다
여기 시럽 한 번만 넣을 수 있어요?	저쪽에서 고객님이 넣으시면 됩니다
텀블러 이거는 얼마에요?	삼만 천 원입니다
텀블러도 세일 할 때 있어요?	세일 안 합니다
에그 샌드위치 데워 주나요?	차갑게 먹는 건데 따뜻하게 데워 드릴까요?
아니요, 바닐라 블랙 티 라테가 뭐예요?	홍차 파우더 들어간 음료에 바닐라 시럽 넣어서 달콤하게 드실 수 있는 티 라테에요
카페라테 따뜻한 거 하나랑 아이스 카페라테 한 잔	드시고 가시는 거예요?
네, 밑에 카페 아메리카노는 그냥 일반 아메리카노 맞죠?	네, 맞습니다
시럽 내가 넣어야 돼요?	네, 아니면 매장에서 판매하는 바닐라 헤이즐넛 카라멜 시럽 있습니다
여기는 자리가 2층에 없어요?	네, 여기는 1층뿐이고, 차는 지하에 주차 하셨어요?
네, 지하에 주차했어요	이거 가져가시면 되세요
시럽은 어디에 있어요?	시럽은 왼편에서 넣으면 되세요
물은 어디 있어요?	잠시만 기다려주시면 준비해드릴게요
카페라테 따뜻한 거 한 잔 주문 여기서 해요?	네, 카페라테 한 잔 맞으시죠?
네, 카페라테 한 잔에 샷 한 번 들어가요?	원샷 들어갑니다
저지방 우유로 넣어주실 수 있어요?	저지방 우유는 거품이 안 나서 안 됩니다
건물 밑 주차장에 주차했는데 괜찮아요?	오늘하고 내일은 괜찮은데 수요일부터는 안 됩니다
시럽은 어디서 넣어요?	준비해드릴까요?
한 번만 좀 넣어주세요	한 번 넣어드렸습니다
카페라테 아이스 괜찮았는데 따뜻한 거랑 맛이 다를 때가 있던데 똑같은 거 맞아요?	네, 카페라테 아이스랑 따뜻한 카페라테 맛 똑같습니다
카페라테 아이스로	네, 사천 삼백 원입니다
쿠폰 같은 거 있어요?	네, 가지고 가시겠어요?
네, 블랙퍼스트 티 라테가 뭐예요?	블랙퍼스트가 홍차인데 우유 위에 뿌려서 나오는 음료에요
갈릭 허니 브레드 위에는 뭐 얹어놨어요?	갈릭 허니 브레드는 지금 안 돼요
밑에 아이스 허니브레드?	아이스 허니브레드는 돼요
아이스크림 있는 저 와플은 두 명 정도 먹을 수 있겠네요	네, 두 명 정도 먹을 수 있습니다
아줌마들 한 일곱 명에서 여덟 명이 모임할건데 미리 예약 안해도 되겠죠?	긴 테이블 하나 있는데 손님들 많이 앉으셔서 언제 오세요?
아직 정해지진 않아서 잘 모르겠고 여기 시럽 한 번만 놔줄래요?	뒤편에 시럽 준비되어있습니다
솔트 치즈 라테 이거는 뭐예요?	위에 크림 올라가는데 단 맛이랑 짠 맛 모두 나는 음료에요
따뜻한 음료에요?	아이스만 되는 음료입니다
연유라테도 좀 달작한거겠네	네, 단 맛 나는 음료입니다
카페라테 따뜻하게 한 잔 주세요	작은 사이즈랑 큰 사이즈 중에 어떤 것으로 하시겠어요?
작은 사이즈로 주세요	이천 팔백 원 결제 도와드리겠습니다
네, 샷은 원샷?	작은 사이즈는 원샷, 큰 사이즈는 투샷 들어갑니다
츄러스는 바로 구워서 주는 거예요?	네, 바로 튀겨서 준비해드립니다
자리는 아무 데나 앉아도 돼요?	네,  원하는 자리에 앉으시면 됩니다
라떼인가 있는 것 같던데	네, 라떼 있습니다
근데 일반 라떼 다른 데랑 똑같은 거예요?	같은 라떼도 있고, 더 가볍고 산미가 있는 라떼도 있습니다
난 약간 고소한 맛을 좋아하는데, 뭐가 좋아요?	일반 라떼를 추천드립니다
아이스 라떼로 주세요	네, 적립이나 영수증 필요하신가요?
영수증만 주세요	네, 오천이백 원 결제해드리겠습니다
적립하면 뭐 있나요?	네, 다 적립하시면 핸드드립 커피 또는 아메리카노를 드립니다
마카롱 가격은 개당 가격인가요?	네, 적혀있는 마카롱 가격은 개당 가격입니다
여기 시럽은 어딨어요?	시럽은 기둥 뒤쪽에 준비되어 있습니다
물티슈도 하나 줄 수 있어요?	물티슈는 모니터 앞에 준비되어 있습니다
에스프레소 콘파냐는 뭐예요?	에스프레소 콘파냐는 생크림이 들어가는 스무디입니다
딸기 프로티펀치는 뭐예요?	딸기 프로티펀치는 딸기 스무디 위에 젤라또 아이스크림이 올라간 음료입니다
딸기 주스는 뭐예요?	딸기 주스는 우유에 딸기를 넣어 만든 라떼 입니다
딸기 주스 하나 주세요	네, 작은 사이즈로 한 잔 드릴까요?
네, 그렇게 해주세요	해피 포인트 적립하시나요?
네 해피 포인트 적립해주세요	네, 적립과 결제해드리겠습니다
치킨 살사 샌드위치는 2인용인가요?	두 조각이 제공됩니다
마시는 물은 어디 있죠?	물은 2층에 준비되어 있습니다
조금 전에 영수증을 안 받은 것 같은데요	네, 영수증 드리겠습니다
조각 케이크 포장해갈 수 있어요?	네, 조각 케이크 포장 가능합니다
얼그레이 다쿠아즈 케이크는 맛이 뭐예요?	얼그레이 다쿠아즈 케이크는 우유 베이스에 밀크티 향이 추가된 맛입니다
에스프레소는 커피 맛이 들어가 있겠네요?	네, 에스프레소 케이크는 커피 맛입니다
뭐드러갔슈는 뭐예요?	뭐드러갔슈는 커스터드 크림이 들어간 슈 케이크입니다
추천해주고 싶은 거 어떤 거예요?	저희 매장이 처음이시라면 뭐드러갔슈 케이크 또는 딸기 시즌 케이크를 추천해드립니다
슈 케이크 포장되죠?	네, 슈 케이크 포장 가능합니다
슈 케이크 얼마에요?	슈 케이크는 이천  원입니다
보관은 냉장 보관하는 거죠?	네, 냉장 보관하시면 됩니다
커피도 맛있어요?	고객님의 입맛에 따라 다르겠지만, 맛있는 커피를 제공하기 위해 매일 맛을 조절하고 있습니다 
둘이 왔는데 한 잔만 좀 시켜도 돼요?	매장에서 드시고 가시면 인 원수에 맞게 음료를 주문하셔야 됩니다
스페셜티 블랜디드  원두는 뭐예요?	스페셜티 블랜디드  원두는 커피를 내려 드실 수 있게 갈아서 판매하는 제품입니다
아이스 아메리카노 한 잔이랑 라떼 따뜻하게 한 잔 주세요	네, 아이스 아메리카노, 따뜻한 라떼 두 잔 해서 육천 육백  원 결제해드리겠습니다
죄송한데, 영수증을 따로 좀 끊어 줄 수도 있나요?	네, 영수증 따로 드리겠습니다
시럽은 뭘 쓰면 돼요?	시럽과 설탕은 셀프 바에 준비되어 있습니다
몇 시에 문 닫아요?	오후 9시 45분까지 영업합니다
아침에는 몇 시에 열어요?	오전 8시에 오픈합니다
냅킨 가져가도 되죠?	네, 냅킨 가져가셔도 됩니다
양이 너무 많아서 그런데 혹시 테이크아웃 잔으로 옮겨줄 수 있어요?	매장 내 일회용 컵 사용이 제한되어, 나가실 때 옮겨드리겠습니다
샌드위치는 직접 만들어서 다 주는 거예요?	네, 샌드위치는 매장에서 직접 만들어서 제공합니다
샌드위치 데워 줘요?	네, 샌드위치는 바로 만들어서 나오기 때문에 따뜻합니다
카푸치노랑 라떼랑 뭐가 틀려요?	카푸치노는 우유가 적고, 우유 거품이 많은 커피이고, 라떼는 우유가 많고, 우유 거품이 적은 커피입니다
카푸치노 하나랑, 라떼 하나랑 따뜻한 걸로 주세요	네, 칠천  원 결제해드리겠습니다
평일날에 몇 시에 문 열어요?	평일은 오전 10시에 오픈합니다
샌드위치 포장도 되죠?	네, 샌드위치 포장 가능합니다
화장실은 어디에요?	화장실은 매장 밖으로 나가셔서 2층으로 가시면 됩니다
키 가지고 가야 돼요?	네, 화장실 키를 가지고 가셔야 됩니다
빈 그릇 두고 가면 돼요?	네, 다 드신 건 두고 가시면 됩니다
아이스 라떼 하나요	매장에서 드시고 가시나요?
가져갈 거예요	네, 사천 오백 원 결제해드리겠습니다
더치커피 파나요?	네, 더치커피 있습니다
레몬 차하고 오미자차 직접 만들은 수제에요?	네, 레몬 차와 오미자차는 매장에서 직접 만들고 있습니다
블루베리 페퍼민트는 차 종류에요?	네, 블루베리 페퍼민트는 차입니다
시럽 한 번만 넣어주세요	네, 시럽 한 펌프 넣어드리겠습니다
우유는 항상 매일 우유만 넣어요?	네, 저희 매장은 매일 우유를 사용하고 있습니다
카페 비엔나는 뭐예요?	카페 비엔나는 아메리카노 위에 휘핑크림이 올라간 음료입니다
베이커리 종류는 없네요	베이커리 메뉴는 허니브레드와 와플이 있습니다
빵은 직접 구워요?	허니브레드는 주문된 빵을 구워서 드리고, 와플은 직접 만들어서 판매합니다
커피 샷이  원샷이에요?	네, 커피에는 샷이 하나 들어갑니다
스팀 밀크는 따뜻한 그냥 우유죠?	네, 스팀 밀크는 우유 스팀기로 따뜻하게 데운 우유입니다
샷 추가가 따로 있네요?	네, 샷 추가 가능합니다
아포카토도 커피에요?	아포카토는 아이스크림에 에스프레소 샷을 부어 먹는 음료입니다
휴무날은 없어요?	명절 전날과 명절 당일에만 휴업입니다
영수증 좀 주세요	네, 영수증 드리겠습니다
카카오 페이도 다 되나 봐요?	네, 카카오 페이 가능합니다
생아메리카노는 뭐예요?	생아메리카노는 일반 아메리카노 입니다
생아메리카노는 에스프레소가 아니라는 얘기죠?	생아메리카노는 에스프레소를 추출해서 만든 음료입니다
생아메리카노 한 잔 좀 주세요	네, 생아메리카노 준비해드리겠습니다
둘이 와서 한 잔 시키는 건 되나요?	죄송하지만, 음료 가격이 저렴한 편이어서 인원수에 맞게 주문하셔야 됩니다
바닐라 보들라떼가 뭐예요?	커피에 바닐라 시럽이 들어간 음료입니다
휴무는 언제예요?	연중무휴입니다
아이스 시킨다는 게 깜빡했다	얼음을 넣어드릴까요?
얼음 좀 많이 넣어주시면 안 될까요?	네, 얼음 많이 넣어드리겠습니다
시럽 한 번 넣어줄 수 있어요?	네,  시럽 한 번 넣어드리겠습니다
아메리카노 아이스 한 잔만 줄 수 있어요?	네, 아이스 아메리카노 한 잔 준비해드리겠습니다
얼그레이는 뭐예요?	얼그레이는 홍차입니다
단백질 바나나 쉐이크는 단백질 파우더 넣어줘요?	네 단백질 바나나 쉐이크에는 단백질 파우더가 들어갑니다
츄러스는 직접 해요?	네, 직접 만들어서 판매합니다
화장실 좀 이용할 수 있어요?	네, 화장실 사용 가능합니다
일요일은 안 하죠?	네, 일요일은 휴업입니다
시럽 한 번만 좀 넣어줄 수 있어요?	네, 시럽 넣어드리겠습니다
카푸치노 주세요	카푸치노 따뜻하게 드릴까요?
네 카푸치노 따뜻하게 주세요	시럽은 넣으시나요?
시럽 조금만 넣어주세요	이천 오백 원 결제해드리겠습니다
라떼는 뭐를 라떼라고 해요?	라떼는 우유에 에스프레소 커피를 넣은 음료입니다
카페라떼 한 잔 주시겠어요?	따뜻한 카페라떼 드릴까요?
네 따뜻한 거 주세요	드시고 가시나요?
네 먹고 가려고요	시럽 넣어드릴까요?
시럽 안 넣을거에요	영수증 필요하신가요?
영수증 주세요	해당 카드는 잔액 부족인데, 혹시 다른 것으로 결제하시겠어요?
만 원 드릴게요	네, 거스름돈 칠천 원 드리겠습니다
현금영수증 되나요?	네, 패드에 전화번호를 입력해주세요
일요일에도 열어요?	네, 일요일도 영업합니다
몇 시에 문 열어요?	오전 11시에 오픈합니다
문은 몇 시에 닫아요?	오후 5시에서 오후 6시 사이에 마감합니다
조각 케이크, 머핀은 여기서 만드는 건 아니지요?	네, 조각 케이크와 머핀은 직접 만들지 않습니다
카페라떼가 우유만 섞어주는 거 아니에요?	네, 우유와 커피가 들어간 음료입니다
카페라떼는 사천 백 원인가요?	카페라떼는 삼천 원입니다
라떼 하나 주세요	따뜻한 라떼로 드릴까요?
네 따뜻한 거로 주세요	네, 음료 준비해드리겠습니다
자몽티 따뜻한 거 얼마에요?	자몽 티는 삼천 오백 원입니다
카페 모카는 뭐예요?	카페 모카는 커피에 초코 시럽이 들어간 음료입니다
영수증은요?	영수증을 드릴까요?
네 영수증 주세요	네, 영수증 드리겠습니다
종이컵 하나 주실 수는 없어요?	네, 종이컵 드리겠습니다
자몽을 금방 갈은 거예요?	담가진 자몽 청을 풀어서 제조했습니다
커피를 먹으면 잠이 안 오는데, 따뜻한 차는 뭐가 괜찮겠어요?	수면을 도와주는 차는 케모마일입니다
레몬과 유자차 중 뭐가 나을까요?	새콤한 맛을 좋아하시면 레몬 차를 추천해드립니다
레몬 차 한 잔 주세요	네, 레몬 차 한 잔 준비해드리겠습니다
레몬 차는 직접 담갔어요?	네, 레몬 청을 직접 담가 판매하고 있습니다
레몬 차는 가루로 타주는 거예요?	레몬 차에는 레몬 농축액이 들어갑니다
레몬 차는 직접 만드신 건 아니죠?	네, 레몬 차는 농축액을 사용합니다
직접 만든 차는 뭐가 있어요?	죄송하지만, 저희 매장은 차를 제조하지 않습니다
루이보스 크림티 저건 뭔데요?	루이보스 티에 우유와 크림이 올라가는 음료입니다
루이보스 크림티는 달아요?	고객님의 성향에 따라 다르겠지만, 크림이 들어가서 달 수도 있습니다
레몬 민트티는 뭐예요?	레몬 민트는 스무디 음료입니다
라떼 한 잔 주세요	라떼 따뜻하게 드릴까요?
네 따뜻한 라떼 주세요	사천 오백 원 결제해드리겠습니다
해피 포인트 전화번호로 적립 돼요?	네, 앞쪽 패드에 전화번호를 입력해주세요
현금 영수증 해주세요	네, 앞쪽 패드에 전화번호를 입력해주세요
빨대는 안 줘요?	빨대 드리겠습니다
순수 에이드 주세요	순수 에이드는 자몽과 오렌지 두 종류가 있는데, 어떤 걸로 드릴까요?
오렌지로 하나 주세요	쿠폰 있으신가요?
쿠폰 집에 있어요	진동벨로 알려드리겠습니다
커피 말고는 뭐가 괜찮아요?	커피 외 음료 중에는 허브티가 잘 나갑니다
허브티 주세요	케모마일, 페퍼민트, 쟈스민, 히비스커스 네 종류 중 어떤 걸로 드릴까요?
허브티 시원한 건 없어요?	허브티도 차갑게 가능합니다
케모마일 차갑게 주세요	드시고 가시나요?
네 먹고 가려고요	사천 오백 원 결제해드리겠습니다
테이크아웃하면 싸나요?	테이크아웃은 아메리카노만 할인됩니다
차는 아무 데나 대도 돼요?	네, 지정 주차장은 없습니다
머랭은 안 파세요?	네, 머랭은 판매하지 않습니다
스무디는 뭐가 잘 나가요?	딸기 스무디가 가장 잘 나갑니다
아이스 아메리카노 하나하고, 딸기 요거트 하나 주세요	네, 오천 삼백 원 결제해드리겠습니다
딸기 요거트는 냉동 딸기죠?	딸기 요거트는 딸기 파우더를 사용합니다
프랜차이즈에요?	네, 저희 매장은 프랜차이즈 매장입니다
차 갖고 오면 잠깐 세워놔도 괜찮나요?	네, 주말에는 매장 앞에 주차하셔도 됩니다
치즈빵 맛있어요?	네, 잘 나가는 빵입니다
꽈배기는 어떤 게 잘 나가요?	생크림 꽤배기와 페스트리 꽤배기가 잘 나갑니다
두 개 중에서는 어떤 게 잘 나가요?	생크림 꽈배기가 잘 나갑니다
커피도 팔죠?	네, 커피도 판매합니다
아메리카노는 얼마씩 해요?	아메리카노는 천 오백 원 입니다
딸기잼 직접 만든 거예요?	저희 브랜드에서 만든 제품입니다
머스켓은 얼마에요?	묶음으로 구천팔백 원, 낱개로 육백 원입니다
커피는 뭐가 잘 나가요?	아몬드 헤이즐넛이 가장 잘 나갑니다
아메리카노 따뜻한 거 하나 주세요	네, 삼천 원 결제해드리겠습니다
차 종류는 뭐 있어요?	현재 레몬티만 주문 가능합니다
화장실은 어디 있어요?	화장실은 지하와 2층에 있습니다
좀 덜 단 게 바닐라 라떼에요?	고객님의 성향에 따라 다르겠지만, 바닐라 라떼에도 시럽이 들어갑니다
카페라떼가 좀 덜 달죠?	네, 카페라떼에는 시럽이 들어가지 않습니다
얼그레이 따뜻하게, 에스프레소, 카페라떼 그렇게 세 잔이요	네, 총 만 천 원 결제해드리겠습니다
차 대는 데는 없죠?	네, 지정 주차장은 없습니다
뜨거운 물 좀 주세요	네, 뜨거운 물 준비해 드리겠습니다
아가씨 커피 어떤 게 잘 나가요?	아메리카노가 가장 잘 나갑니다
아메리카노 한 잔 주세요	네, 사천 원 결제해드리겠습니다
빵은 직접 만든거예요?	네, 빵은 직접 만들어서 판매합니다
빵은 뭐가 잘 나가요?	빵은 모든 메뉴가 잘 나갑니다
아이스커피 중에서는 어떤 게 잘 나가요?	아이스 아메리카노가 가장 잘 나갑니다
아메리카노 아이스 하나 주세요	사이즈는 레귤러로 드릴까요?
레귤러는 얼마에요?	레귤러 사이즈는 사천 백 원입니다
빵 종류는 없어요?	네, 빵은 판매하지 않습니다
영수증 하나 주세요	네, 영수증 드리겠습니다
얼음 너무 많이 넣지 마세요	네, 얼음 적게 해드리겠습니다
아가씨 라떼 중에서는 따뜻한 거 뭐가 잘 나가요?	바닐라 라떼가 가장 잘 나갑니다
바닐라 라떼는 달죠?	네, 바닐라 라떼는 시럽이 들어가서 단 편입니다
덜 단 거는요?	일반 라떼가 달지 않습니다
그냥 라떼는 얼마에요?	라떼는 삼천  원입니다
쿠키는 직접 구운거 아니죠?	네, 쿠키는 직접 굽지 않습니다
사장님, 핸드드립은 직접 뽑는 거에요?	손으로 커피 가루 갈아서 내리는 거고, 여과지에 거르기 때문에 부드럽고 깔끔한 맛이 납니다
아이스 커피로 천천히 해주세요	네, 아이스 커피로 준비하겠습니다
아메리카노 말고 뭐가 잘나가요?	아주머니들 많이 있는 곳에는 라떼가 좀 많이 나가고 오피스 지역은 아메리카노가 잘 나갑니다
라떼는 무슨 라떼가 잘 나가요?	라떼는 그냥 라떼가 제일 많이 나갑니다
아이스로 먹으려면 아메리카노 먹어야 되죠?	네, 아메리카노 드셔야 합니다
저는 아이스 아메리카노 한 잔 주세요	네, 오천 원 결제해 드리겠습니다
휴지는 어디있죠?	네, 제가 휴지 드리겠습니다
커피 뭐가 잘 나가요?	커피는 따뜻한 아메리카노가 제일 잘 나갑니다
따뜻한 아메리카노 얼마에요?	삼천 원입니다
아메리카노 한 잔 하고, 오리지날 프레즐 하나 주세요	지금 오리지날 프레즐 다 팔려서 스틱만 판매하고 있습니다
오리지날 프레즐 다 팔렸어요?	네, 크림 치즈 스틱이랑, 아몬드 크림 치즈 스틱 중에서 선택 가능하세요 
그럼 놔두고, 따뜻한 아메리카노만 주세요	네 영수증 드릴게요
이거 커피콩알은 직접 만드는 거에요?	예, 저희가 반죽 기계에 넣어서 만듭니다
속 안에 들어가는 건 없어요?	네, 커피 반죽 자체만 들어갑니다
따뜻한 아메리카노 한 잔 주세요	이천 원이고, 드시고 가시는 거에요?
네, 아메리카노 마시고 갈거에요	잠시만 기다려주세요
밀크티는 어떤 걸로 만드는 거에요?	밀크티 가루가 있습니다 
성분이 홍차인지, 아니면 뭐에요?	홍차랑 우유맛 내는거랑 섞여져 있습니다
밀크티에 우유를 넣는게 아니에요?	저희가 따로 그 맛을 내는 우유도 넣습니다 
더치 커피는 직접 내리시는 거에요?	네, 저희가 여기 기계로 내립니다
이게 더치 커피 오백미리에요?	네, 더치 커피 오백미리입니다
아메리카노 따뜻한 거 있죠?	네, 아메리카노 따뜻한 거 있습니다
아메리카노 따뜻한 거 하나 주시고, 바닐라 라떼는 어떤 거에요?	바닐라 시럽 들어간 거 입니다
바닐라 라떼 하나 주세요	따뜻한 바닐라 라떼인가요?
네, 라지하고 사이즈가 어느 정도 차이나요?	여기 보시면 사이즈가 있으세요
이게 제일 큰 사이즈에요?	제일 큰 게 벤티 사이즈고, 한 단계 아래 사이즈는 레귤러입니다
아메리카노는 라지로 주시고, 바닐라 라떼는 레귤러로 주세요	테이크 아웃 하세요?
네 테이크 아웃이요	영수증 필요하세요?
네 영수증 주세요	진동벨로 알려드리겠습니다
말차 카페 라떼가 뭐에요?	말차랑 카페 라떼랑 섞인 커피입니다
말차가 뭔데요?	녹차랑 비슷하다고 생각하시면 됩니다
아몬드 카페 라떼 하나하고, 아메리카노 하나, 밀크티 라떼 따뜻한 거 한 잔이요	네, 만 팔천 원 결제해드리겠습니다
십프로 할인해주세요	십프로 하시면 만 육천 이백 원입니다
먹다가 남으면 테이크 아웃 해주시는거죠?	네, 테이크 아웃 해드립니다
저긴 찬 물인데, 따뜻한 물 좀 주세요	잔 가져오시면 해드리겠습니다
아가씨, 치즈폼 딥초코 스무디는 어떤 재료가 들어가요?	초콜렛이랑 치즈폼이고, 치즈폼은 우유 휘핑크림 밀크폼에다가 치즈가루를 넣은거에요
치즈폼 딥초코 스무디는 부드러워요?	네, 근데 초코랑 치즈폼 자체가 단 맛이나서 조금 달달합니다
치즈폼 자체가 좀 달아요?	네, 단 맛, 짠 맛, 신 맛이 같이 납니다
쟈스민 그린티는 뭐에요?	쟈스민 그린티는 녹차인데 쟈스민 향이 나는 녹차입니다
블랙티는 뭐에요?	홍차입니다
그것도 홍차에 펄 넣어서 주는거에요?	네, 홍차에 펄 넣어 드리는 것입니다
블랙 밀크티는 뭐에요?	홍차에 우유를 갈아 태워서 마시는 음료인데 손님들이 그 걸 가장 많이 드세요
블랙 밀크티도 맛 조절이 가능해요?	맛 조절 단계랑 얼음을 선택하실 수 있습니다
블랙 밀크티는 그럼 따뜻하게는 안돼요?	네, 따뜻하게 됩니다
그럼 블랙 밀크티 주세요	블랙 밀크티 펄 있는거로 드릴까요?
펄 있는 블랙 밀크티로 하면 얼마에요?	사천 이백 원입니다
큰 사이즈는 안돼요?	큰 사이즈는 오천 사백 원입니다
그럼 블랙 밀크티 큰 사이즈로 하나 주세요	큰 사이즈에다 따뜻한 블랙 밀크티 말씀이세요?
네, 따뜻하게 해주세요	당도는 어떻게 할까요?
당도는 삼십정도 해주세요	공차 멤버쉽 있으세요?
네, 있습니다	홈플러스 멤버쉽 적립하세요?
네, 적립합니다	음료 우측에서 드리겠습니다
많이 뜨거운가요?	네, 조금 뜨거우니 누르거나 기울이지 마세요
카라멜 마끼아또는 어떤거에요?	카라멜 시럽이랑 커피랑 우유들어간거요
우유가 많이 들어가나요?	네 우유가 많이 들어갑니다
그러면 커피는 몇 개 정도 들어가요?	커피는 투샷 들어가요
커피 단정도는 어때요?	카라멜 마끼아또 엄청 달아요
그럼 따뜻한 아메리카노 한 잔 주시는데 투샷이에요?	네 아메리카노 투샷이에요
요기 만약 텀블러에 하면 어떻게 되죠?	텀블러에 담으시면 사백 원 할인 되요
텀블러에 담으면 몇 그램 들어가요?	텀블러에 담아봐야 알 거 같습니다
컵으로 했을 때는 몇 그램 나오는데요?	컵으로 했을 때는 삼백 삼십 그램이요
카라멜 마끼아또 텀블러에 담아주세요	네 삼천 구백 원이고 영수증 필요하세요?
네 영수증 주세요	커피는 오른쪽에서 드릴게요
커피에 시나몬 좀 뿌려주세요	네 뿌려드릴게요
따뜻한 아메리카노 샷 몇 개 들어가죠?	아메리카노에 샷 한 개 들어갑니다
여기 더치 커피도 직접 내려요?	더치 커피 저희가 직접 내립니다
이 커피 용량 몇 미리 짜리에요?	커피 용량은 오백미리 짜리에요
용량 더 큰거는 안나오나요?	네 이게 제일 큰 사이즈에요
저 물이랑 시럽 좀 더 부어주세요	네 잠시만 기다려주세요
바닐라 라떼는 어떤가요?	바닐라 라떼는 커피랑 우유랑 바닐라 시럽 들어간거에요
그러면 그냥 아메리카노로 하나 주세요	아메리카노 드시고 가세요?
네 여기서 마시고 가려구요	커피는 진하기는 어떻게 해드릴까요?
커피 연하게 해주세요	네 커피 연하게 해드릴게요
커피 연하게 하는 거는 샷이 몇 개 들어가요?	저희 기본 샷이 두 개인데 연하게는 한 개 들어가요
여기 T멤버쉽 있으면 할인되요?	네 T멤버쉽은 할인 되세요
음료 다 못먹으면 테이크 아웃도 해주시죠?	네 테이크 아웃 해드립니다
라떼 중에 덜달고 순한게 있나요?	저희 카페라떼는 시럽 아예 안 들어가서 안 달아요
우유는 싫어하는데 라떼 종류는 다 그래요?	네 라떼 종류는 우유 다 들어가요
아메리카노 한 잔 주시고 개인 텀블러에 담으면 할인 되나요?	텀블러에 담으면 할인 해드릴게요
아메리카노에 물 많이 넣어서 좀 연하게 해주세요	텀블러에 담으시니까 오백 원 할인해드릴게요
근데 카드로 결제해도 되나요?	네 카드 결제 가능하세요
영수증 좀 주세요	네 영수증 드릴게요
아메리카노는 원래 샷이 몇 개에요?	아메리카노에 원샷 들어가요
그러면 아메리카노 원샷으로 주세요	따뜻한 아메리카노로 드릴까요?
네 따뜻한 아메리카노 한 잔 주세요	잠시만 기다려주세요
연유라떼는 뭐에요?	말그대로 연유랑 에스프레소랑 우유 들어가구요
연유라는게 우리가 빙수에 뿌려먹는 연유 그거 말하는 거에요?	네 그렇게 파는게 스타벅스에 돌체라떼인데 연유 들어가요
연유랑 커피가 잘 어울려요?	네 원래 스페인가면 사람들이 에스프레소에 연유만 뿌려서 먹거든요
사장님 여기 와이파이는 안되나요?	와이파이 가능하세요
와이파이 비밀번호가 어떻게 되죠?	핸드폰 주시면 제가 잡아드릴게요
프라페는 차가운 거에요?	네 프라페에 얼음 막 갈아서 차가운 거에요
밤라떼는 밤이 들어가요?	밤을 삶아서 들어가는데 다른 가게처럼 액기스 그런 걸로 안해요
여기는 밤 자체를 그냥 넣으시는거에요?	네 밤라떼 맛있을 거에요
그럼 밤라떼 하나 주세요	네 잠시만 기다려주세요
카드로 계산 해도 되나요?	네 카드 결제 가능합니다
그러면 여기는 생과일 주스 이런 것도 전부 생과일 갈아서 하시겠네요?	냉장고 보시면 아시겠지만 생과일에다가 저희는 첨가물 같은거 안 넣습니다
쿠폰 하나 만들어주세요	네 만들어 드릴게요
쿠폰은 몇 개 먹어야 한 잔 주고 이런거에요?	쿠폰에 적혀 있듯이 열 번 먹으면 아무거나 드시고 싶은거 한 잔 드려요
가격 상관없이 아무 커피나요?	네 가격 상관없이 한 잔 드려요
블랙화이트는 뭐에요?	우유 적게 들어가고 커피가 많이 들어간 거에요
그러면 블랙화이트는 단 것이 아예 안들어가는거에요?	사이즈가 큰 거는 많이 들어가고 작은 거는 적게 들어가고 다 달라요
블랙화이트도 사이즈가 있어요?	작은 사이즈는 없고 중간 사이즈랑 큰 사이즈 있어요
그러면 카페라떼 하나 주시고 설탕은 추가로 해야되나요?	설탕 넣어드릴까요?
설탕 많이는 넣지 말고 조금만 넣어주세요	그러면은 따로 드릴테니까 조절하세요
제가 설탕 조절해야돼요?	손님 조금이랑 저의 조금이랑 다르잖아요
그러면 설탕 따로 주세요	라떼 따뜻한 거 한 잔 맞으세요?
네 라떼 따뜻한 거 한 잔 맞습니다	드시고 가세요?
아니요 가지고 갈게요	따뜻한 라떼 한 잔 삼천 오백 원입니다
여기는 할인되거나 할인되는 카드는 없어요?	따로 없고 저희 포인트 카드가 있는데 포인트 카드 만드시면 5프로씩 적립해드립니다
영수증 좀 주세요	영수증 여기 있고 라떼는 섞어드시면 돼요
여기 설탕 얼마나 넣어야 되나요?	3분의 1정도만 넣으시면 됩니다
설탕말고 시럽은 없어요?	뜨거운 라떼는 설탕이 잘 녹아서 설탕만 녹여도 맛있어요
따뜻한 라떼에 시럽보다 설탕이 나아요?	네 따뜻한 라떼는 시럽보다 설탕이낫습니다
홍시 스무디 있나요?	홍시 스무디는 지금 안돼요
홍시 스무디 왜 안되나요?	홍시 스무디가 재료가 다 떨어져가지구요
홍시가 없는거에요?	네 오전까진 다 됐는데 점심 때 다 나가가지고요
홍시 스무디가 잘나가나봐요?	네 그래서 홍시 다시 공수해와야돼요
그러면 아메리카노 한 잔 주세요	따뜻한 아메리카노 맞으신가요?
네 따뜻한 아메리카노 맞아요	따뜻한 아메리카노 한 잔 삼천 오백 원 결제해드릴게요
샷은 몇 개 들어가죠?	샷은 한 개 들어가요
시럽은 얼마나 들어가나요?	시럽은 이거 가져가시면 됩니다
여기 와이파이 되나요?	와이파이 키셔서 IPTIME 사용하시면 돼요
와이파이 비밀번호 알려주세요	와이파이 비밀번호 없습니다
와이파이 개방형인가요?	네 와이파이 개방형 맞습니다
화이트 카페모카는 많이 달아요?	휘핑크림하고 화이트 초코가 들어가요
화이트초코요?	네 흰색 초코요
그럼 많이 달겠네요?	휘핑크림도 올라가고 초코도 있어서 좀 달아요
비엔나 커피도 달아요?	비엔나는 아메리카노에 휘핑크림 올라가는거라서 많이 달진 않아요
그럼 비엔나 커피 하나 주세요	커피 따뜻한 거 차가운 거 어떤 걸로 드릴까요?
커피 차가운 것도 되나요?	커피 차가운 것도 됩니다
얼음 좀 작게 넣어주세요	얼음 작게 넣어 드실거면 따뜻하게 드시는게 나을 것 같습니다
따뜻한 비엔나 커피는 많이 안 달아요?	네 단 거 좋아하시면은 거기다가 설탕 넣어 드셔도 되고 안 달아요
혹시 그 위에 다가 시나몬 가루 좀 뿌려주실 수 있나요?	네 시나몬 가루 뿌려드릴게요
여기 혹시 와이파이 되나요?	네 와이파이 키셔서 커피토리 연결 후 비밀번호 **** 치시면 됩니다
모히또는 어떤 거에요?	모히또는 에이드처럼 탄산 들어가는 겁니다
약간 톡 쏘는 그런거에요?	네 바 같은데서 파는 칵테일 같은 것인데 무알콜이라고 생각하시면 돼요
그러면 클랜즈는 뭐에요?	클랜즈는 착즙주스 같은건데 녹즙같은거라고 생각하시면 돼요
클랜즈는 그럼 생과일로 직접 짜서 주는거에요?	저희가 여기서 해드리는건 아니고 저희가 이제 제품을 받아서 팩처럼 개별로 이렇게 포장이 돼있어요
플레인 요거트도 포장 가능해요?	매장 내 전 품목 테이크 아웃 가능하세요
그러면 플레인 요거트 하나 주시는데 많이 안달죠?	덜 달기는 한데 아이스 제품이신거는 알고 계시죠?
네 아이스 제품인거 알고 있습니다	플레인 요거트 한 잔 오천 오백 원입니다
리얼 쇼콜라는 뭐에요?	리얼 쇼콜라는 핫초코라고 생각하시면 편해요
아메리카노로 하나 주세요	아메리카노 드시고 가세요?
예 먹고 가려구요	아메리카노 한 잔 사천 삼백 원입니다
할인되는 카드 그런건 없어요?	네 할인되는 카드 따로 없습니다
쿠키는 여기서 직접 만드나요?	네 쿠키는 저희가 직접 만듭니다
아메리카노 테이크 아웃으로 좀 해주세요	네 테이크 아웃으로 해드리겠습니다
영수증도 같이 부탁드려요	네 영수증도 같이 드릴게요 
오트밀 라떼는 뭐 들어가는거에요?	곡물들어가는 미숫가루라고 생각하시면 돼요
오트밀 라떼도 차가운 건가요?	따뜻한 것도 있고 차가운 것도 있어요
그러면 단 정도는 어때요?	달기는 조절해드릴수 있어요
그러면 원래 오트밀 라떼 자체가 좀 단 거에요?	아니요 오트밀 라떼 아예 안 달아요
오트밀 라떼 크기 조절 가능해요?	네 크기 조절 가능합니다
오트밀 라떼 한 잔 주세요	오트밀 라떼 따뜻한 걸로 드려요?
네 따뜻한 오트밀 라떼 부탁드릴게요	오트밀 라떼 한 잔 삼천 오백 원입니다
여긴 몇 시에 문열어요?	아침 9시에서 저녁 10시까지 문열고 주말에는 9시 30분에 문열어요
저기 앉아서 먹을 수도 있나요?	네 음료 가져가셔서 드시면 돼요
여기는 주문한 다음에 2층 가서 마셔야 되나봐요?	네 음료 주문 후 2층 올라가셔야 됩니다
목이 지금 칼칼하면서 안 좋은데 어떤 거 마시면 좋을까요?	시원하게 페퍼민트 드시는거 추천드려요
페퍼민트 허브티로 하나 주세요	적립번호 있으세요?
아니요 없는데 하나 만들면 뭐 있나요?	적립번호 만드시면 10프로 적립되는데 만들어 드릴까요?
네 적립번호 만들어주세요	음료는 삼천 원이고 결제 후 만들어드릴게요
네 이 카드로 결제해주세요	카드 받았고 여기 전화번호랑 성함 적어주세요
음료 받아서 올라가야되나요?	올라가 계시면 갖다 드릴게요
여기 혹시 와이파이 되나요?	네 2층에 와이파이 비밀번호 적혀 있어요
카페라떼 따뜻한 거 하나 주세요	카페라떼 드시고 가시는 건가요?
아니요 텀블러 가져오면 텀블러에 담아주시나요?	네 텀블러에 담아드려요
양 조금 더 주고 그런거 있어요?	아니요 담아준다고 더 주는거 없습니다
적립은 되는가요?	아너스 회원이여야지 할인 가능하시고 쿠폰 10개 다 찍으시면 그때 아너스회원증 발급되시고 그래야 10퍼센트 할인 되세요
쿠폰 10개 찍어야 회원증 발급되요?	10개 마다 오천 원 커피 할인에다가 다 채우시면 회원증 발급해드리구요
라떼 따뜻한 거 테이크아웃으로 한 잔 주세요	쿠폰 찍어드릴까요?
네 쿠폰 찍어주세요	영수증 드릴까요?
네 영수증 주세요	음료 다 되면 진동벨로 알려드리겠습니다
라떼 하나 주세요	라떼 진하게 해서 드릴까요?
네 여기는 우유는 뭘로 써요?	우유는 그냥 서울우유요
여기 체인점이에요?	아니요 지금은 아니에요
예전에는 체인점이였어요?	처음에 오픈할 때는 체인이였는데 지금은 아니죠
원두를 다른데서 받아오시는데가 있어가지고 카페 운영 하는거에요?	원두는 로스팅 전문업체에서 제가 따로 주문해요
어디꺼 쓰시는데요?	원두는 이제 영업비밀이라서 못 알려드리고 거의 최상급 원두 쓴다고 보시면 돼요
제 친구도 커피숍 하는데 대부분 여러가지 섞어서 한다고 하는데 맞나요?	대부분이 물 커피 재료 에스프레소 추출은 거의 블랜딩이에요
텀블러 갖고오면 거기 담아 주시죠?	네 따로 가지고 오시면 담아드려요
라떼 하나 얼마에요?	따뜻한 라떼는 이천 오백 원이고 시원한 라떼는 삼천 원이요
따뜻한 라떼 하나 주시고 여기 적립카드 있어요?	적립카드는 쿠폰 말씀하시는거에요?
네 쿠폰 같은거요	네 쿠폰 있습니다
쿠폰 하나 주시겠어요?	네 쿠폰 여기 있습니다
쿠폰은 어떻게 하면 되는거죠?	10개 찍으시면 이천 오백 원짜리 공짜로 드려요
여기 혹시 카카오페이 결제도 되는가요?	카카오페이 결제는 안됩니다
진하게 먹으려면 샷 추가 하는 거에요?	샷 추가하셔야 진하게 드실 수 있으세요
휴지 좀 가져가도 되는거죠?	네 휴지 가져가셔도 되시고 음료 나왔습니다
라떼 진하게 먹으려면 샷을 추가하는 거에요?	추가비는 없고 진하게 연하게 다 가능해요
그러면 조금 진하게 라떼 따뜻한 거 한 잔 주세요	음료 가져가시나요?
아니요 먹고 갈 거에요	라떼 한 잔 사천 오백 원입니다
카카오페이 결제도 되는가요?	카카오페이 결제 안 되세요
어느정도 기다리면 되나요?	자리에 있으시면 가져다 드리겠습니다
제가 시간이 없어 그러는데 커피를 제가 가지고 다니는 텀블러에 담아 주시겠습니까?	네 커피 텀블러에 담아 드릴게요
아메리카노 한 잔 주시겠어요?	음료 드시고 가실거에요?
네 마시고 가려구요	네 편안한 자리 이용하시면 돼요
카페 콤파냐는 뭐에요?	콤파냐는 에스프레소에다가 생크림 올려드리는거에요
생크림은 시중에서 파는 제품으로 하시는거에요?	저희 가게에서 파는 생크림 저희가 직접 만들어요
그냥 아메리카노 따뜻한 걸로 한 잔 주시고 농도 조절 할 수 있나요?	농도는 제가 기본 조금만 넣어드리고 좀 더 필요하시면 말씀해주세요
네 그냥 농도는 기본으로 해주세요	네 필요하시면 말씀해주세요
혹시 와이파이 비밀번호 여기 있습니까?	여기 바로 앞에 비밀번호 적혀 있습니다
화장실은 어디 있어요?	화장실은 바로 정면에 보시면 있습니다
이 과자는 뭐에요?	커피랑 같이 드시면 맛있을거에요
죄송한데 물 좀 한 잔 주시겠어요?	네 잠시만 기다려주세요
아침에는 몇 시에 문 열어요?	아침 10시에 문 열어요
저녁에는 몇 시에 문 닫아요?	저녁 11시에 문 닫아요
치즈케잌 없어요?	죄송한데 조각 치즈케잌은 지금 여기 나와있는게 다에요
생크림 소프트 쉬폰 이거는 무슨 맛이에요?	그거는 생크림 안에 쉬폰 들어가 있어요
스타벅스에 그런 빵하고 비슷한가요?	네 약간 그럼 느낌의 빵이라고 생각하시면 돼요
생크림 소프트 쉬폰 이거 하나 주세요	빵 드시고 가세요?
아니요 빵 포장해주세요	빵 이천 오백 원 결제 도와드릴게요
여기는 할인이나 적립되는 카드 뭐죠?	CJ ONE 적립되고 아니면 CJ카드라고 붙여져 있는거요
빵 세 시간에서 네 시간 있다가 먹으려면 보관은 어떻게 해야돼요?	빵을 냉장고에 넣어두시면 되세요
포장이라도 기다려야돼요?	네 조금만 기다리시면 돼요
혹시 물티슈 줄 수 있어요?	물티슈 몇 개 드릴까요?
물티슈도 두 개 주세요	물티슈 여기 있습니다
원조커피가 뭐에요?	믹스커피라고 생각하시면 돼요
아이스크림도 있어요?	네 아이스크림 있습니다
소프트 아이스크림이 1500원인데 카라멜 추가하면 500원더 추가되나요?	네 토핑으로 올라가요
노말한 아이스크림이 뭐에요?	바닐라 아이스크림입니다
아메리카노 한 잔 주세요	따뜻한거 드릴까요?
네 티머니로 결제도 돼요?	네 결제할 수 있습니다
적립이나 할인은 없나요?	적립은 지금은 없고 3월 중순쯤 생길 예정입니다
영수증 주시고 샷은 몇 개에요?	두 개입니다
하나만 해주세요	네 다됐습니다
뜨거워서 그런데 얼음 3개만 넣어주세요	네 알겠습니다
이게 몇 미리에요?	그게 사이즈가 크게 나왔어요
작은 사이즈 나왔으면 좋겠습니다	작은 사이즈 있어요
종이 빨대 있어요?	종이 빨대는 아직 안나왔어요
테이크아웃하면 2000원 되어있는데 맞아요?	아메리카노 말씀하시는거세요?
네	네 2000원입니다
생크림 카스텔라 스타벅스에 파는거랑 비슷한거에요?	네 비슷합니다
하나 포장 가능한가요?	네 포장할수 있습니다
포장 부탁드릴게요	생크림 카스텔라 대자로만 포장하시는거에요?
예	4400원 결제 도와드릴게요
돌체라떼는 뭐에요?	커피종류입니다
진짜딸기우유라고하는거는 여기서 만든거에요?	네 직접 만들어요
한 병에 얼마에요?	5800원 입니다
자몽청도 여기서 만든거에요?	네 만들었어요
자몽청 이거는 그냥 따뜻한 물에 차처럼 타먹어도 되는거죠?	따뜻하게 하셔도 되고 차갑게 하셔도되고 탄산수에 타먹어도 됩니다
테이크아웃 되죠?	네 가능합니다
아이스 아메리카노 더치커피랑 아메리카노 맛이 많이 틀리나요?	원두에 따라 다르기도 한데 일단 커피만드는 방식자체가 달라가지고 맛은 차이가 나요
아이스 아메리카노 한 잔 주세요	네 3900원 결제해드릴게요
몇 시에 문열어요?	10시에 열어요
시럽 한 번만 넣어주세요	네 알겠습니다
커피 지금 먹을 수 있나요?	네 먹을수 있습니다
사장님 여기 2층에도 해요?	2층은 아예 안합니다
라떼 한 잔 살게요	따뜻한 거 맞으세요?
아니요 시원한거요	시원한 걸로 드릴게요
멤버십 같은 거 있나요?	skt할인 되고 쿠폰해드릴까요?
아니요 괜찮습니다	준비되면 진동벨로 알려드릴께요
네 영수증 좀 주세요	네 여기있습니다
스파클링에이드 많이 달아요?	어떤 종류 스파클링 말씀하시나요?
망고들어간거요	많이 달지 않습니다
시럽은 어디있어요?	뒤쪽에 빨대랑 같이 있습니다
종이컵에 물 한 컵 얻어가도 될까요?	뒤쪽에 종이컵있는데 주시면 담아드리겠습니다
플랜클링 이거 탄산들어있는거에요?	네 다 들어있습니다
많이 달아요?	많이 달진않고 어느정도 단 맛은 있어요
플랜클링레몬 하나 주세요	4000원 결제 도와드릴게요
씨제이카드 있으면 적립되나요?	네 번호 입력해주세요
저쪽에 있는건 아이스크림이죠?	아니요 떠먹는 케이크에요
얼음은 그냥 무료로 주시나요?	네 무료입니다
여기 몇 시까지해요?	11시 50분까지 합니다
여기 시원한게 뭐 어떤게 있죠?	커피종류 말씀하시는건가요?
아니요 커피말구요	네 티종류에도 얼그레이 자스민 있고 아니면 고구마라떼 홍차라떼 초콜릿티 복숭아티 이렇게 있습니다
아이스 아메리카노는 얼마에요?	3800원입니다
두 개 주세요	네 잠시만 기다려주세요
저 베이글은 뭐 발라서 주는거에요?	베이글은 플레인맛이랑 어니언맛 있습니다
그럼 바르는 소스는 따로 없는거에요?	저희 바르는 소스는 따로 없고 크림치즈를 이렇게 드려요
여기서 데워서 주는거에요?	네 데워서 드립니다
아이스아메리카노 두 개만 주세요	네 뜨거운 물 같이 준비해드릴까요?
아뇨 뜨거운 물 놔두고 아이스아메리카노만 주세요	네 쿠폰도 만들어 드릴까요?
네 화장실 어디있나요?	저쪽에 푸드코트쪽으로 쭉 가시면 돼요
여기 주차권은 무료되나요?	주말에는 5시간 무료에요
휴지는 어딨어요?	냅킨 오른쪽에 있어요
여기 생과일 주스는 뭐가 있어요?	자몽이랑 바나나랑 토마토있어요
차 종류는 이거에요?	차는 메뉴판보면 티종류에 있어요
바나나주스는 어떻게 만드는거에요?	생과일 바나나넣고 우유넣고 만드는거에요
너무 달진 않아요?	생과일 주스 중에는 달아요
시럽을 많이 넣어서 그래요?	벌꿀을 넣습니다
에스프레소 콘파냐는 뭐에요?	에스프레소위에 콘파냐 올라가는거에요
토마토주스 작은 거 되나요?	레귤러가 제일 작은컵이에요
토마토주스 너무 달게하진 말고 하나 주세요	드시고 가세요?
네 먹고갈께요	5300원입니다
카드되죠?	네 가능합니다
영수증 주세요	잠시만 기다려주세요
이거 먹다가 테이크아웃되나요?	가져오시면 저희가 잔을 바꿔드려요
자몽주스하고 자몽에이드는 뭐가 차이점이에요?	에이드에는 설탕이 들어갑니다
자몽주스는 그냥 자몽 생으로 가는 거에요?	계랑컵에 물이랑 희석해서 갈아요
여기 앉을까요?	아무데나 앉으시면 저희가 불러드릴께요
에그햄머핀은 양이 많아요?	맥도날드 머핀만한 크기입니다
민트라떼는 어떤거에요?	민트시럽이랑 커피랑 나가는거에요
라떼면 우유들어가요?	네 들어갑니다
많이 달아요?	달기보단 민트향이 강하게 나요
카페라떼 한 잔 주세요	따뜻한거 맞으세요?
네 루이보스 바닐라도 루이보스랑 바닐라 두 개가 합쳐진거에요?	네 두 개 합쳐진겁니다
레귤러가 제일 작은거에요?	네 라떼랑 카푸치노 한 잔 맞으세요?
네	드시고 가세요?
네	영수증 드릴까요?
네 카푸치노 한 개 카페라떼로 바꿀 수 있나요?	네 변경 가능합니다
여기 식사도 있나 봐요?	네 냉동필라프 있습니다
내맘대로 커피는 샷을 조절 할 수 있는거에요?	네 조절 하는 거에요
여기 복지카드 할인되죠?	복지카드는 원플러스원 커플요금제입니다
멤버십 VIP고객은 안 되는 거에요?	네 커플요금제만 가능합니다
카푸치노가 좀 쓰나요?	조금 쓸 수도 있어요
부드럽게 할 수 있나요?	샷을 하나 빼시면 됩니다
원래는 투 샷이에요?	원래 투 샷입니다
한 샷 반으로 해주세요	네 따뜻하게 해드려요?
네 따뜻하게 해주시고 여기 라자냐있죠?	네 있습니다
라자냐는 양이 많나요?	양이 그렇게 많지는 않아요
바닐라딜라이트 주세요	네 드시고 가시죠?
네 먹다가 혹시 밖으로 나가고싶으면 테이크아웃잔에 담아주세요?	네 가져오시면 돼요
애플그린씨 안에 계란들어있는거에요?	네 들어있습니다
여기는 리필정책이 있네요?	네 리필해드립니다
할리스매장은 다 리필되는거에요?	다 되는데 머그컵으로 드셨을 경우에만 리필해 드립니다
여기 주차장공용이죠?	네 공용입니다
유로드립이 우리 일반적으로 마시는 것보다 순해요?	네 유로드립은 상대적으로 연한 편입니다
샷은 몇 개나 추가되는 거예요?	유로드립은 샷이 들어가지 않고, 내려 마시는 음료입니다
여기 딸기 주스는 없어요?	네 죄송하지만 딸기 주스는 없습니다
생딸기 주스 없어요?	네 죄송하지만 생딸기 주스는 없습니다
큐브라떼도 커피인가요?	큐브라떼는 얼린 커피에 뜨거운 우유를 넣어 녹여 마시는 음료입니다
큐브라떼는 맛이 좀 강해요?	고객님의 입맛에 따라 다르겠지만, 큐브라떼는 일반적인 아이스 라떼와 비슷합니다
유로드립 한 잔 하구요, 카푸치노 주세요	카푸치노는 따뜻하게 드릴까요?
네	네 카푸치노 따뜻하게 준비해드리겠습니다
삼성페이 결제 되나요?	네 삼성페이 결제 가능합니다
테이크아웃잔은 안 되죠?	테이크아웃잔에 드릴 수 있습니다
핸드폰은 조심해서 만져주세요	네 알겠습니다
삼성페이가 안돼면 다른 카드로 계산할게요	네 알겠습니다
사이드는 다콰즈 종류 외에는 없어요?	고객님, 죄송하지만 다른 종류는 다 팔렸습니다
얼그레이하고 레몬차 중에서 좀 덜 단 맛이 나는건 어떤거죠?	얼그레이와 레몬차는 단 맛을 내는 재료가 똑같이 들어갑니다 
여기 커피가 좀 맛이 강한가요?	저희 매장은 커피에 에스프레소 샷을 두 개 넣고 있습니다
혹시 좀 덜 진하게 할 수 있나요?	네 연하게 가능합니다
아인슈페너는 뭐죠?	아인슈페너는 진한 아메리카노 위에 크림을 올린 음료입니다
아인슈페너 한 개랑 아메리카노 따뜻한거 하나 주세요	네 결제 도와드리겠습니다
영수증 주세요	네 영수증 드리겠습니다
혹시 따뜻한 물 좀 얻을 수 있을까요?	네 따뜻한 물 준비해드리게습니다
유자차 따뜻한 거는 4500원이에요?	네 따뜻한 유자차는 4500원입니다
레몬유자차하고 유자차하고 차이점이 뭐예요?	레몬유자차는 레몬청과 유자청이 모두 들어가고, 유자차는 유자청만 들어갑니다
얼그레이는 뭐예요?	얼그레이는 홍차입니다
생과일 주스는 어떤게 있어요?	생과일 주스는 판매하지 않습니다
자몽에이드는 너무 달지는 않죠?	고객님의 입맛에 따라 다르지만, 자몽에이드는 단 맛을 내는 재료가 들어가는 음료입니다
자몽에이드하고 카푸치노 주세요	카푸치노는 따뜻하게 드릴까요?
따뜻하게 주세요	네 13400원 결제해드리겠습니다
적립되는 카드는 없어요?	죄송하지만, 적립되는 카드는 없습니다
스탬프도 없어요?	네 스탬프로 적립할 수 없습니다
주차는 무료로 되는 거예요?	차를 어디에 세우셨나요?
앞에 세워놨거든	영수증을 보여주시면 무료로 주차 가능합니다
여기서 먹을건데 왜 테이크아웃잔에 줘요?	테이크아웃 매장이기 때문에 모든 음료는 테이크아웃잔에 제공됩니다
진저라떼 생강이 들었어요?	네 진저라떼에는 생강이 들어갑니다
커피에다가 생강을 넣나요?	진저라떼는 커피는 들어가지 않고, 생강청으로 제조합니다
케이크 같은건 없어요?	케이크는 아직 준비되지 않았습니다
식혜는 얼마인데요?	식혜는 2500원입니다
아메리카노는 샷이 몇 개 들어가요?	아메리카노에는 샷이 두 개 들어갑니다
아메리카노 원 샷으로 해주세요	네 아메리카노 준비해드리겠습니다
영수증도 주세요	네 영수증 드리겠습니다
생긴지 얼마나 됐어요?	저희 매장은 1년 넘게 운영하고 있습니다
음료에 얼음 몇 개 넣어주세요	네 음료에 얼음 넣어드리겠습니다
작은 사이즈 테이크아웃 아메리카노 얼마에요?	아메리카노 작은 사이즈는 1800원입니다
따뜻한 아메리카노 주세요	네 1800원 결제해드리겠습니다
작은거는 얼마고, 큰거는 얼마에요?	작은 사이즈는 1800원, 큰 사이즈는 2800원입니다
적립 같은건 안 해요?	적립 쿠폰이 있습니다
적립 쿠폰 주세요	네 적립 쿠폰과 방문 쿠폰 드리겠습니다
방문 쿠폰은 뭐예요?	방문 쿠폰은 방문할 때마다 스탬프를 찍어드리며, 다 채우시면 100원으로 사용하실 수 있습니다
영수증 좀 주세요	네 영수증 드리겠습니다
여기는 프랜차이즈에요?	네 저희 매장은 프랜차이즈 매장입니다
몇 시까지 해요?	오후 11시까지 영업합니다
아침에는 몇 시에 열어요?	오전 11시에 오픈합니다
프랜차이즈에요?	저희 매장은 프랜차이즈가 아닙니다
메뉴는 누가 만드는 거예요?	사장님이 직접 만드십니다
말린 과일은 설탕을 넣은 거예요?	말린 과일은 100퍼센트 과일입니다
말린 과일은 다 2000원씩이에요?	네 말린 과일은 2000원입니다
생긴지 얼마나 됐어요?	오픈한지 3개월이 되었습니다
테이크아웃하면 싸게 해주는거 없어요?	네 테이크아웃 할인은 없습니다
베니스카푸치노랑 바닐라카푸치노랑 뭐가 달라요?	베니스카푸치노는 카푸치노 위에 생크림이 올라가고, 바닐라카푸치노는 카푸치노에 바닐라 시럽이 들어갑니다
일반 카푸치노 따듯하게 하나 해주실래요?	네 카푸치노 준비해드리겠습니다
카드해도 돼요?	네 카드 결제 가능합니다
46** 회원 등록되어 있나 봐주실래요?	네 46**은 회원 등록이 되어 있습니다
아그로타타마는 무슨 뜻이에요?	아그로타타마는 콜롬비아 유기농 원두입니다
영수증 좀 주실래요?	네 영수증 드리겠습니다
바닐라 라떼는 일반 라떼랑 다르죠?	네 바닐라 라떼는 유기농 사탕수수 시럽이 들어갑니다
오후에는 가게 앞에 주차해도 되나요?	가게 앞은 주차단속 구간이기 때문에 주차하실 수 없습니다
에이드 다 생과일로 해주나요?	네 에이드는 생과일로 제조합니다
레몬에이드 한 잔은 얼마에요?	레몬에이드는 2000원입니다
아메리카노 있어요?	네 따듯한 아메리카노와 차가운 아메리카노가 있습니다
아메리카노 한 잔 주세요	아메리카노 따뜻하게 드릴까요?
네 따뜻한거 주세요	네 따뜻한 아메리카노 준비해드리겠습니다
라떼 종류는 다 우유가 들어가는 건가요?	네 라떼 종류에는 우유가 들어갑니다
쿠폰 없어요?	네 쿠폰 적립은 하지 않고 있습니다
과일 주스는 생과일이에요?	네 과일 주스는 생과일로 제조합니다
블루베리 주스 한 잔 주세요	네 블루베리 주스 준비해드리겠습니다
적립은 없어요?	네 적립은 하지 않고 있습니다
컵 빙수도 지금 하나요?	네 컵 빙수 주문 가능합니다
아메리카노 제일 작은 사이즈로 3개 주세요	아메리카노 따뜻하게 드릴까요?
아이스로 주세요	시럽 넣어드릴까요?
넣지 말고 주세요	캐리어는 20원인데 필요하신가요?
네 캐리어 주세요	네 음료와 캐리어 준비해드리겠습니다
쿠폰 도장 찍어주나요?	1500원 이상이면 적립해 드립니다
땅콩 카라멜 라떼는 땅콩이 들어가나요?	네 땅콩하고 카라멜 넣은 메뉴입니다
브이적힌 건 뭡니까?	브이는 벤티사이즈이고 알은 레귤러, 작은 사이즈입니다
여기는 체인인가요?	네 체인으로 전국에 있습니다
카라멜 마끼야또에도 우유 들어가나요?	네, 들어갑니다
우유가 안들어간 거는 있나요?	안들어가는 건 아메리카노 뿐입니다
아메리카노 레귤러 사이즈 하나 주세요	따뜻하게 드릴까요?
네, 따뜻하게요	천오백원입니다
체크카드로 할게요	네, 레귤러 사이즈는 투 샷이 들어가서 진할 수 있는데 괜찮으세요?
네, 여기는 포인트 할인은 없나요?	10잔 찍으면 한잔 무료인 쿠폰이 있습니다
뜨거워서 얼음3개만 넣어주세요	네 알겠습니다
이거 처음 나올때 몇도입니까?	85도 입니다
배달도 되나요?	배달은 안됩니다
마카롱은 여기서 만드나요?	네 마카롱은 여기서 만듭니다
가격은?	마카롱은 2000원입니다
인터넷판매도 하나요?	매장이나 sns에서만 팝니다
sns는 어디로 들어가면 되나요?	인스타랑 페이스북에서 주문하시고 찾으러 오시면 돼요
커피 주세요	아메리카노 드릴까요?
아메리카노 한잔 주세요	네 아메리카노 한잔 드리겠습니다
카푸치노도 되나요?	네 카푸치노도 됩니다
카드로 할게요	네 결제해드리겠습니다
뚜껑 닫지 말아주세요	네 뚜껑 없이 드리겠습니다
영업은 몇시까지 하시나요?	10시정도인데 손님있으면 12시까지 영업합니다
커피는 로스팅 된 거를 쓰시나요?	로스팅을 되어있는 걸 들고옵니다
여기에 시나몬 가루 뿌릴 수 있나요?	네 시나몬 가루 뿌릴 수 있습니다
카페모카랑 카푸치노랑 어떻게 달라요?	초코시럽에 모카가 들어갑니다
치즈케이크도 있어요	치즈케이크 있습니다
치즈케이크은 얼마에요?	9000원입니다
치즈케이크 하나 주세요	네 치즈케이크 하나 드리겠습니다
포인트 적립있어요?	저희는 포인트 적립 제도가 없습니다
따듯한 물 한잔 있어요?	네 따듯한 물 한잔 드릴게요
커피찌꺼기 남은 거 있어요	아뇨 지금은 커피찌꺼기 없습니다
대만 샌드위치가 뭐에요?	햄, 계란이 들어간 샌드위치입니다
여기는 텀블러가지고 오면 할인되나요?	할인은 안되고 텀블러 크기에 맞춰서 음료를 조금 더 드립니다
전부 과일 인가요?	네, 생과일쥬스 집이에요
커피도 있어요?	커피도 있습니다
덜 찬 건?	따뜻하게 드시는 것도 있습니다
우유를 들어간 메뉴 있나요?	우유는 메뉴에 전부 들어갑니다
얼음 안들어가는 건?	얼음 안들어가는 건 없습니다
생딸기쥬스 작은 거 하나 주세요	2500원 계산해드리고 영수증 드릴까요?
네 주세요	지금 바로 드시는거에요?
네	빨대 꽂아 드릴게요
포인트 적립도 있어요?	어플 다운로드하시면 가능합니다
사이즈는 한 가지 인가요?	네 벤티사이즈 한 종류입니다
벤티가 어떤 거죠?	20온즈 600미리 사이즈입니다
체인점이죠	네 체인점입니다
아메리카노 작은 사이즈로 주세요	네 아메리카노 작은 사이즈 드리겠습니다
투 샷 들어가나요?	네 투 샷 들어갑니다
원 샷으로 주세요	따뜻한 걸로 드릴까요?
네 따뜻한 걸로요	연하게 드시나요?
컵은 작은거 없나요?	컵 뚜껑 없는 건 작은 사이즈 있습니다
네 그걸로 주시고 적립되나요?	7잔 드시면 1잔 무료입니다
적립 어떻게 해요?	핸드폰 번호로 적립 가능합니다
영수증 좀 주세요	네 영수증 드리겠습니다
커피를 캔에 담아주시는건가요?	캔에 담아 드릴수도 있고 원하시면 종이컵에도 담아드립니다
캔에 하면 가격은?	캔에 담아도 가격은 똑같습니다
메뉴 다 되는 건가요?	휘핑올라가는거 빼고 다 가능합니다
테이크아웃하면 할인 되나요?	아뇨 테이크아웃 할인 없습니다
텀블러는 할인되고?	텀블러는 할인됩니다
한 샷 반 돼요?	네 한 샷 반 됩니다
아메리카노 한샷 반 주세요	아이스로 드릴까요?
핫으로 주세요	2800원입니다
쿠폰은 10개하면 1개 무료에요?	네 쿠폰은 10개 드시면 1개 무료제공입니다
영수증 주세요	네 영수증 드리겠습니다
커피종류는 어떤 거 있어요	일반 커피류도 있고 비엔나 커피도 있습니다
일반 커피하고 비엔나 커피랑 뭐가 달라요?	원두가 달라서 비엔나 커피가 조금 더 부드럽습니다
슈가는?	들어가는 거 있고 안들어가는 거 있습니다
어떤 게 잘나가요?	고객님은 단 거 좋아하시나요?
아니요	일반 라떼로 주문 도와드릴까요?
원산지는 어디 꺼죠?	이탈리아, 케냐, 만델리 있습니다
달지 않은 음료로 과일주스는 있나요?	애플망고 있습니다
생과일인가요?	퓨레 사용합니다
애플망고 주스는 가격이 얼마에요?	애플망고 주스 가격은 5800원입니다
텀블러가지고 오면 할인은 되나요?	텀블러 할인은 없습니다
할인 카드는 따로 없나요?	네 할인 카드는 따로 없고 쿠폰이 있습니다
오픈한 지 얼마 안됐죠?	1년되었습니다
몇 시부터 몇 시까지 영업해요?	9시반에서 11시반까지 영업합니다
아메리카노 한 잔 주세요	따뜻한 걸로 드릴까요?
따뜻한 걸로 주세요	가져 가시겠어요?
포장해주세요	쿠폰 하나 드릴까요?
네 쿠폰 주세요	아메리카노 진하게 선택 가능한데 해드릴까요?
진하게 주시고 컵도 큰 컵으로 가능한가요?	사이즈 업은 500원 추가 되는데 하시겠어요?
아니요 화장실은 어디 이용해요?	1층도 있고 2층도 있습니다
토요일, 일요일도 영업하세요?	저희는 명절 당일만 쉽니다
어떤 게 잘나가요?	아메리카노가 제일 잘나갑니다
샷은 몇 개 들어가요?	원 샷 들어갑니다
샷 추가 시 추가요금 있나요?	네 샷 추가 시 추가요금 있습니다
따뜻한 음료는 커피 말고 어떤 거 있어요?	메뉴판 보여드리겠습니다
여기선 어떤 게 잘나가요?	유자차, 생강차, 허브티 같은 차 종류가 많이 나갑니다
사이즈는 세 가지 있어요?	큰 거, 작은 거 두 가지있습니다
가격 차이 나겠네요	사이즈업하면 천원 추가됩니다
돌체라떼는 뭐에요?	우유 들어간 커피입니다
아메리카노 먹다가 남으면 포장도 해주나요?	네 포장해드립니다
컵 비용 따로 추가되진 않죠?	네 포장 컵 비용 따로 추가되지 않습니다
아메리카노 한 잔 주세요	따뜻한 걸로 드릴까요?
네 몇 시부터 몇 시까지 영업해요?	아침 10시 30분부터 저녁 10시까지 영업합니다
차기지고 오면 어디다 세워요?	가게 앞에 세우시면 됩니다
커피는 원산지 어디에요?	원두를 몇 가지를 섞어서 직접 로스팅을 합니다
화장실이 밖에 있어요?	네 밖에 있습니다
다 못마셔서 그런데 포장해주세요	네 포장해드리겠습니다
카드 결제돼요?	네 카드 결제됩니다
포인트 적립있어요?	네 전화번호로 포인트 적립 가능합니다
따뜻한 음료 어떤 거 있어요?	커피 종류 많이 있습니다
돌체라떼는 뭔가요?	카페라떼에 연유 넣은 메뉴입니다
시럽 들어가나요?	시럽은 따로 안들어가고 연유만 들어갑니다
아메리카노하고 더치 아메리카노하고 어떻게 차이가 나요?	아메리카노는 뜨거운 물로 만들고 더치는 차카운 물로 만듭니다
더치도 뜨겁게도 되나요?	네 더치 커피도 뜨겁게 가능합니다
컵 사이즈도 있나요?	컵 사이즈는 하나입니다
샷 추가 시 추가요금 있나요?	샷 추가 시 추가요금 500원입니다
생과일 주스도 가능해요?	지금은 생과일 주스는 키위만 가능합니다
아메리카노로 뜨겁게 해주세요	네 아메리카노 주문받았습니다
마시고 갈 건데 못마시면 포장돼죠?	네 포장가능하고 2500원입니다
카드 돼요?	카드 결제 가능합니다
할인카드 없죠?	할인카드는 없고 쿠폰은 있습니다
영수증 주세요	영수증 드리겠습니다
주차는 앞에 하면 되나요?	평일에는 주차하면 안됩니다
몇 시부터 몇 시까지해요?	아침 8시부터 밤 11시까지합니다
명절에는 휴무 없어요?	설 당일만 휴무입니다
아메리카노에는 샷 몇 개 들어가요?	아메리카노에는 샷 하나 들어갑니다
커피 중에 덜 단 게 어떤 거에요?	덜 단 게 라떼입니다
그린라떼는 커피들어가나요?	그린라떼는 커피 안들어갑니다
카페라떼로 주세요	사이즈는 어떤 거 드릴까요?
작은 걸로 주세요	드시고 가시겠어요?
테이크아웃하면 더 저렴해요?	테이크아웃해도 가격은 똑같습니다
샌드위치 구매하면 아메리카노 무료로 제공되나요?	샌드위치 구매하시면 아메리카노 무료로 제공됩니다
아메리카노 주세요	따뜻한 거 드릴까요?
예	드시고 가시는 건가요?
테이크아웃은 더 싸나요?	테이크아웃은 500원 할인됩니다
테이크아웃 해주세요	시럽 안넣으셔도 돼요?
네 영수증도 주세요	영수증 드리겠습니다
청도 만들어서 파나요?	매실하고 자몽청 만들어서 판매하고 있습니다
그릇은 파는 건가요?	판매하는 겁니다
그릇 얼마씩 해요?	2만 원 정도합니다
밀크하고 블랙하고 어떻게 틀려요?	밀크는 우유 들어가고 블랙은 물 들어갑니다
라떼 종류 중에 많이 안 단 건 어떤 거에요?	라떼만 안달고 나머지는 전부 답니다
더치라떼 따뜻한 거 하나 주세요	시럽 조금만 넣을까요?
많이 말고 조금만 넣어주세요	3000원 결제하겠습니다
이걸로 결제 해주세요	쿠폰 하나 드릴까요?
네 영수증도 주세요	영수증 드리겠습니다
생강차는 생강분말 들어가요?	생강청이 들어갑니다
수삼주스는 뭐에요?	수삼갈아서 만든 주스입니다
수삼주스는 얼마에요?	수삼주스는 5500원입니다
아메리카노 따뜻한 거 한 잔 주세요	2800원 결제 도와드릴게요
마시고 갈게요	영수증 필요하세요?
네 햄치즈는 얼마씩 해요?	5000원입니다
로얄밀크티는 뭐에요	로얄밀크티는 홍차에 티백을 넣은 것입니다
커피가 들어간 거인가요?	로얄밀크티는 커피가 들어가지 않습니다
카페라떼도 커피 들어가요?	카페라떼에는 커피가 들어갑니다
솔트 치즈 카페라떼 하나 주세요	따뜻한 걸로 드릴까요?
네 여기도 체인점이죠	네 체인점입니다
여기 뒤에 차 잠깐 세워도 되나요?	주차는 이쪽 라인 빈자리에 하시면 됩니다
많이 안달죠?	솔트 치즈 카페라떼는 많이 안답니다
커피말고 뭐 있나요?	라떼도 있고 주스도 있습니다
어떤 게 잘나가나요?	곡물 라떼와 고구마, 블루베리, 딸기, 망고주스가 잘나갑니다
블루베리는 냉동이죠?	블루베리는 냉동입니다
블루베리 주스를 먹을게요	드시고 가시겠어요?
네 곡물라떼는 어떤 게 들어가요?	곡물가루가 들어갑니다
블루베리 주스는 시럽 들어가요?	안넣고 싶으시면 안넣어 드립니다
몇 시까지해요?	영업시간은 6시까지입니다
커피 어떤 게 맛있어요?	단거 좋아하시면 아이슈페너가 좋고 더치커피도 잘나갑니다
더치는 아메리카노랑 비슷한가요?	아메리카노보다는 조금 연해요
더치커피 하나 주세요	아이스로 하시는 거세요?
따뜻하게 주세요	드시고 가세요?
가지고 갈게요	더치커피 테이크아웃으로 주문받았습니다
여기 테이크아웃하면 할인되는 거 없어요?	테이크아웃 시 할인되지 않습니다
시럽 조금 넣어 주세요	시럽 한 번이 기본이라서 한번 넣어 드렸습니다
물티슈 있어요?	화장실에 가시면 물티슈 있습니다
커피 원두는 다 같은거죠?	원두는 다 같습니다
비엔나는 어떤 거에요?	아메리카노에 휘핑 들어갔습니다
카페라떼 아이스로 하나 주세요	가지고 가시는 거에요?
네 얼음은 조금만 넣어주세요	샷 더 넣어 드릴까요?
원래하던데로 해주세요	연하다 싶으면 더 넣어 드릴게요
주차장은 앞에 있나요?	주차장은 뒤에도 있습니다
1리터 커피가 뭐예요?	1리터 커피는 대용량 아이스 아메리카노인데, 테이크 아웃만 가능하세요
텀블러 가져오면 따로 할인이 되나요?	텀블러 할인은 따로 없는데, 테이크 아웃 하시면 무조건 천원씩 할인이 돼요
카푸치노 한 잔 주시겠어요?	테이크 아웃 하시는 건가요?
아니요, 마시고 갈게요	3500원이에요
적립되는 카드 있나요?	네, 적립 쿠폰 하나 만들어 드릴까요?
아니요 다음에 해주세요	네 말씀해주시면 바로 분쇄도 가능해요
원두는 로스팅 하시나요? 아니면 분쇄 해주실 수 있나요?	12000원이랑 14000원짜리 두 가지 있어요
저 원두는 얼마인가요?	200g이에요
원두 한 봉지가 몇 그램인가요?	카푸치노는 에스프레소에 우유를 넣고 위에 우유 거품을 올리는 거예요
이 카푸치노는 어떻게 만드는 거에요?	라떼는 거품이 적고 우유가 많아서 부드러운데, 카푸치노는 우유가 적어서 상대적으로 더 진해요
그럼 카페 라떼랑은 뭐가 다른 건가요?	끓인 물은 미네랄이 다 없어지는데, 미네랄이 있는 물로 내린 커피가 제일 맛있어요
더치는 끓인 물로 하는 건가요?	코웨이 정수기를 사용해요.
정수기는 어떤 거 사용하세요?	네, 직접 하고 있어요
여기 로스팅도 직접 하시는 거에요?	차 종류는 이쪽에 있어요
차 종류는 어디에 있어요?	블랙티는 홍차예요
블랙티가 어떤 것인가요?	맞아요. 홍차가 약간 들어가요
밀키티도 홍차 넣은 거 아닌가요?	유자레몬티 드릴까요?
유자레몬티는 뭔가요?	유자레몬티랑 오렌지 자몽주스 종류가 있어요
따뜻한 거는 유자레몬티밖에 없나요?	블랙티와 프렌치 얼그레이는 향이 약간 달라요
블랙티랑 프렌치 얼그레이가 어떻게 다른가요?	작은 거는 하나이고, 더블은 두개가 들어가요
에스프레소는 샷이 몇 개 들어가나요?	CJ카드가 적립 가능하세요
어느 카드가 적립되나요?	네 통신사 카드는 따로 적립이 되지 않으세요
LG카드는 적립이 안 되나요?	뜨거운 물이요, 잠시만요
뜨거운 물 한 잔 받을 수 있을까요?	에스프레소에는 물이 안들어가고 샷만 추출되는거예요
에스프레소에 물이 얼마나 들어가나요?	텀블러는 가져오시면 300원 할인 되요
텀블러 가져오면 할인 되나요?	테이크 아웃 할 때 텀블러에 담아가시기 때문에 할인이 되요
텀블러 가져오면 테이크 아웃 할 때도 똑같이 할인 되나요?	텀블러를 사용하시기 때문에 300원 똑같이 할인되세요
매장에서 텀블러를 사용하면요?	에스프레소는 원액을 말하는거고, 에스프레소 콘파냐는 그 위에 휘핑크림이 올라가는 거예요.
에스프레소와 콘파냐의 차이가 뭔가요?	커피 원액이랑 하겐다즈 아이스크림 하나가 딱 올라가는 음식이에요
아포카토는 뭐예요?	깔끔한 맛을 원하시면 아메리카노가 제일 잘 나가고, 달달한 맛을 좋아하시면 라떼나 바닐라라떼 처럼 우유 들어간 음료도 많이 찾으세요
주로 많이 나가는 제품은 어떤 것인가요?	저희 쪽에서 테이크 아웃 잔에 남은 음료를 담아드려요
혹시 다 못 마시면 어떻게 하나요?	네, 아파트 지하에 주차 가능하세요
여기 주차는 가능 한가요?	뒤쪽으로 나가시면 돼요
사장님, 여기 화장실이 어디에 있나요?	네, 테이크 아웃 잔에 담아 드릴게요
사장님, 다 못 마신 음료 포장 좀 해주시겠어요?	네 빨대 하나 드릴게요
빨대 하나 가져가도 될까요?	달달한 음료 찾으세요?
잘 나가는 커피가 무엇인가요?	바닐라 카라멜마끼아또도 있고 스윗앤솔티 라떼랑 연유 라떼 많이 나가는데 스윗앤솔티 라떼는 덜 달게도 가능하세요
네, 그런데 너무 달지 않은 걸로 부탁드려요	더치 커피는 그냥 커피인데 허니 더치 라떼는 더치 라떼에 원당시럽을 넣어 달게 드시는 음료예요
더치 커피하고 허니 더치 라떼의 차이점이 있나요?	에스프레소는 그냥 커피 원액이고 아메리카노는 그 원액에 물을 타 드시는 음료예요
에스프레소하고 아메리카노의 차이점은 뭐예요?	저희 가게에서는 투샷이 들어가고 있어요
아메리카노 샷이 얼마나 들어가나요?	네, 시럽이나 휘핑 추가 가능하신데 휘핑은 500원 금액 추가가 돼요
시럽이나 휘핑 추가 가능한가요?	따로 할인되는 카드는 없고 도장 찍는 쿠폰 드리고 있어요
할인되는 카드 있나요?	네, 한 잔인데 3900원짜리에요
도장 10개면 한 잔 주시는 건가요?	네, 기본적으로 잘 나가고 있어요
아메리카노도 잘 나가나요?	3300원이요
아메리카노에 샷 추가하고 시럽도 조금 추가해 주세요	다 못마시면 나가실 때 저희가 테이크 아웃 잔으로 옮겨 담아 드려요
네, 혹시 다 못 마시면 어떻게 하나요?	네, 영수증 드릴게요
영수증 좀 주시면 안될까요?	치즈케익 한 종류 밖에 없어요
커피랑 같이 먹을 수 있는 디저트류는 없나요?	1800원이요
이건 가격이 얼마예요?	네, 핸드폰 충전 가능하세요
핸드폰 충전 가능한가요?	네, 테이크 아웃 잔에 담아 드릴게요
이거 다 못 마셔서 그런데 포장 좀 해주세요	화장실은 2층으로 올라 가시면 있어요
화장실이 어디 있나요?	커피 종류가 많아서 메뉴판으로 드릴게요
커피는 종류가 어떻게 있나요?	헤이즐넛 아메리카노는 헤이즐넛 시럽이 들어가 조금 더 달아요
아메리카노랑 헤이즐넛 아메리카노의 차이가 뭐예요?	아메리카노에 꿀이 들어간 거예요
꿀 아메리카노는 뭐예요?	사이즈가 1리터되는 커피예요
메가리카노는 뭐예요?	기본 투샷이 들어가고, 샷 추가 하시면 500원이 추가 돼요
샷 추가하면 돈이 얼마 추가 되나요?	저희가 쓰는 원두는 100퍼센트 아라비카산이예요
원두의 원산지가 어딘가요?	카페 라떼는 샷에 우유 밖에 안들어가서 달지 않아요
카페 라떼는 당도가 어느 정도 인가요?	라떼애 연유가 들어가서 약간 달달해요
연유 라떼는 당도가 어느 정도 인가요?	따뜻한 음료는 1가지 이고, 아메리카노는 큰 사이즈 하나 밖에 없어요
음료 컵 사이즈는 3가지 인가요?	1500원이에요
따뜻한 아메리카노 한 잔 주세요	네, 카드 가능하세요
카드 되나요?	적립하실 때 핸드폰 번호 눌러주시면 돼요
적립 카드 있는데 적립 가능한가요?	외부 음식은 매장에서 드실 수 없어요
음식 포장한 거 있는데 매장에서 음료랑 같이 먹어도 되나요?	화장실은 중앙 통로로 가시면 돼요
화장실은 어디에 있나요?	아침 9시 30분부터 저녁 9시까지 해요
영업 시간이 어떻게 되나요?	커피 안 좋아하시면 유자티나 레몬티가 잘 나가요
따뜻한 음료 중에는 뭐가 잘 나가나요?	잼이 들어가서 꽤 달아요
당도가 어느 정도인가요?	화이트 카페 모카는 화이트 파우더가 들어가는데 카라멜 카페 모카는 카라멜 시럽이 들어가요
화이트 카페 모카하고 카라멜 카페 모카의 차이점이 뭐예요?	컵은 큰 사이즈로 나가요
유자티는 컵 사이즈가 어떻게 되나요?	유자에이드는 사이다가 들어가는 음료예요
유자에이드는 뭐예요?	네, 카드 가능하세요
따뜻한 유자티 한 잔 더 뜨겁게 주세요, 카드 되나요?	적립되는 카드는 없어요
적립되는 카드 있나요?	저는 잘 모르겠어요
이 근처에 서점이 있나요?	매장에 홀이 없어서 드시고 갈 수 없으세요
매장에서 먹고 갈 수 있나요?	네, 체인점이에요
여기 체인점인가요?	카라멜 마끼아또는 라떼에서 카라멜 시럽이 들어간거고 카페 라떼는 샷에 우유만 들어가요
카라멜 마끼아또랑 카페 라떼의 차이점이 뭐예요?	에스프레소는 샷 원액이고, 아메리카노는 거기에 물을 더 넣어 마시는 음료예요
에스프레소랑 아메리카노의 차이가 뭐예요?	30cc 투샷 들어가요.
아메리카노에는 샷이 몇 개 들어가요?	스몰, 레귤러, 라지 3종류 있어요
컵 사이즈는 몇 종류가 있어요?	스몰이 4300원이고 각 사이즈 별로 500원씩 차이가 나요
컵 사이즈별 가격이 어떻게 되나요?	네, 테이크 아웃 잔에 담아드리는데 10분 정도만 계시면 일회용 컵에 드릴 수 있어요
다 못 마시고 가면 포장 가능한가요?	금방 가시면 종이컵에 드릴까요?
아메리카노 작은 사이즈로 한 잔 주시겠어요?	네, 머그잔에 드릴게요
그냥 여기서 마시고 갈게요	L포인트 카드나 롯데 카드 할인 가능하세요
할인되는 카드 있나요?	화장실은 밖으로 나가셔야 돼요
화장실은 어디에 있나요?	네, 테이크 아웃 잔에 담아 드릴게요
다 못마신 음료 포장 좀 해주시겠어요?	핫 초코예요
완전 초코는 뭐예요?	네, 스무디라 차가워요
피스타치오는 차가운 음료인가요?	원조 커피가 다방 커피랑 비슷해요
다방 커피같은 음료 있나요?	따뜻한 음료 맞으세요?
원조 커피 한 잔 주세요	2000원이요
네, 따뜻한 걸로요	우유는 안 들어가고 본사에서 나오는 베이스가 들어가요
그거 우유 들어가는 거 맞죠?	네, 영수증 드릴게요
영수증 줄 수 있나요?	네, 10번 찍으면 무료 쿠폰 드리는 거 있는데 드릴까요?
적립 쿠폰도 있나요?	네, 지점마다 따로 찍으셔야 해요
아니예요	시럽은 따로 두지 않고 저희가 넣어 드려요
다른 지점이랑은 다른 쿠폰인가요?	네, 빈 컵은 그 곳에 두세요
시럽은 어디 있어요?	케이크 말씀하시는 거 맞으세요?
빈 컵은 어디 두나요?	리얼 베리 케이크예요
아까 시킨 메뉴 이름이 뭐예요?	햄에그치아버터는 햄, 계란 그리고 치즈가 들어가고 크로크마담은 햄이랑 치즈만 들어가요
네, 네모난 케이크요	네, 오븐기에 구워요
햄에그치아버터랑 크로크마담은 재료가 뭐예요?	네, 기계 예열을 해야해서 20분정도 걸려요
구워서 하시는거예요?	지점마다 달라요
와플은 시간이 20분 걸리나요?	물 이 쪽에 있어요
다른 곳도 이렇게 20분씩 걸리나요?	네, 영수증 드릴게요
물은 어디에 있나요?	그냥 나가시면 돼요
제가 아까 영수증 안받았는데	네, 물티슈 하나 더 드릴게요
주차 확인 쿠폰이 필요한가요?	네, 빈 그릇 여기에 두면 돼요
물티슈 하나 더 받을 수 있을까요?	카푸치노는 에스프레소에 우유넣고 위에 우유 거품, 시나몬을 뿌리고 카페 모카는 라떼에 초코시럽이 들어가고 위에 휘핑 크림이 올라가요
빈 그릇은 여기에 두면 되나요?	네, 휘핑 크림을 뺄 수 있어요
카푸치노랑 카페 모카랑 뭐가 다른가요?	다른 메뉴 하셔도 돼요
카페 모카에서 휘핑 크림을 뺄 수 있나요?	쿠폰이랑 같거나 더 높은 가격으로 고르셔야 해요
이 쿠폰은 반드시 이 메뉴를 먹어야 하나요?	매장에서 드시다가 다 못드시면 테이크 아웃 잔으로 옮겨 드려요
쿠폰이랑 다른 메뉴가 가격이 다르면 어떻게 하나요?	카푸치노는 쿠폰보다 금액이 커서 결제가 되지 않아요
매장에서 다 못먹으면 어떻게 하나요?	남은 금액 저장은 되지 않아서 쿠폰이랑 가격이 같거나 커야 해요
카푸치노 한 잔 주시겠어요?	베이글은 오븐에 구워서 나가고 크림 치즈는 따로 나가요
금액이 클 때는 남은 금액 저장을 하면 안 되나요?	네, 포장 가능하세요
크림 치즈 베이글은 어떻게 나오나요?	네, 가능하세요
먹다가 남으면 포장 가능한가요?	물 컵은 종이컵 사용하시면 돼요
해피포인트 적립 되나요?	네, 2층에도 종이컵이 있어요
물 컵 따로 있나요?	네, 주문 도와드릴게요
2층에도 종이컵이 있나요?	드시고 가셔도 돼요
커피 주문 해도 될까요?	카페 라떼는 달지 않아요
이 가게는 테이크 아웃 전문점이가요?	네, 카페 라떼에는 우유만 들어가요
라떼 종류는 다 단가요?	카푸치노는 샷에 우유 들어가고 위에 우유 거품이랑 시나몬 가루가 올라가요
카페 라떼는 우유만 들어가나요?	카페 모카는 카페 라떼에 초코 시럽이 들아가고 많이 달아요
카푸치노는 뭐예요?	카푸치노 한 잔 따뜻하게 드릴까요?
카페 모카는 뭐예요?	네, 저희는 음료만 있어요
카푸치노 한 잔 주시겠어요?	있는데 한 장 드릴까요?
네, 따뜻한 걸로 주세요	한 장 드릴게요
네, 다른 사이드 메뉴는 없나요?	가지고 가시나요?
이 집은 따로 쿠폰같은게 없어요?	네, 앞에 전화번호 눌러 주세요
하나 만들어야 되겠다	네, 군고구마를 직접 갈아서 만들어요
카푸치노 한 잔 주시겠어요?	네, 가능하세요
먹고 갈게요	저희 가게 카페 모카는 덜 단 편이에요
현금 영수증 되나요?	카페 모카는 4500원이에요
고구마 라떼의 고구마를 오븐에 직접 구워서 하나요?	네, 음료랑 함께 드릴게요
카페 모카도 텀블러에 담아갈 수 있나요?	미숫가루랑 우유에 꿀이 들어가는 거예요
카페 모카가 많이 달아요?	네, 치즈 케이크도 팔아요
카페 모카는 얼마인가요?	카페인이 들어가지 않은 커피예요
영수증 줄 수 있나요?	아메리카노랑 맛은 비슷한데 조금 연해요
오곡 라떼는 뭔가요?	네, 커피 종류는 모두 디카페인 종류로 바꿀 수 있어요
치즈 케이크도 파나요?	따뜻한 걸로 드릴까요?
디카페인은 뭔가요?	네, 콜드브루 있어요
아메리카노보다 맛이 연한가요?	콜드브루는 찬물로 8시간 이상 천천히 내리는 커피고 아메리카노는 그라인더로 바로 내리는 커피예요
아메리카노도 디카페인으로 주문할 수 있어요?	병원 주차장을 이용하시면 돼요
아메리카노를 디카페인으로 주세요	네, 더치 커피 있어요
네, 따뜻한 걸로 주세요	제일 큰 사이즈 더치 커피는 28500원이에요
콜드브루 파나요?	콜드브루랑 더치 커피가 같은 음료예요
콜드브루랑 아메리카노랑 뭐가 달라요?	둘 다 잘나가요
주차장은 어디인가요?	둘 다 달아요
더치 커피 있나요?	바닐라 라떼는 에스프레소에 바닐라맛아이스크림이 들어가고, 토피넛 라떼는 에스프레소에 호두나 땅콩 다진 것을 넣어요
더치 커피는 큰 사이즈가 얼마예요?	콜드브루 커피에 질소를 넣어 내리는 커피에요
콜드브루도 더치 커피처럼 병에 담아 파나요?	바닐라 라떼 한 잔, 따뜻한 걸로 드릴까요?
바닐라 라떼랑 토피넛 라떼 중 뭐가 더 잘나가나요?	따뜻한 바닐라 라떼 한 잔, 3500원이에요
바닐라 라떼랑 토피넛 라떼 중 뭐가 더 달아요?	네, 텀블러 할인 200원이에요
바닐라 라떼랑 토피넛 라떼의 차이가 뭐예요?	네, 본사에서 만들어요
질소 커피는 뭐예요?	앞에 공영주차장을 이용하세요
바닐라 라떼 한 잔 주시겠어요?	아니요, 적어지지 않아요
네, 따뜻한 걸로 주세요	네, 콜드브루 커피 있어요
텀블러 할인은 200원인가요?	아메리카노는 글라인더로 바로 내리는 거고 콜드브루는 찬물로 8시간 이상 천천히 내리는 커피예요
토피넛 라떼는 회사 내에서 만드는 건가요?	네, 텀블러에 담아드릴게요
주차장은 어디인가요?	콜드브루 한 잔, 따뜻하게 드릴까요?
텀블러에 넣으면 양이 적어지나요?	아니요, 설탕은 안들어가요
콜드브루 커피 있나요?	콜드 브루 원액에 우유가 들어가는 거예요
콜드브루랑 아메리카노랑 뭐가 달라요?	따뜻하게 드릴까요?
텀블러에 담아주실 수 있나요?	콜드브루가 일반 커피보다 맛이 연해요
콜드브루 한 잔 주시겠어요?	영수증 드릴게요
따뜻하게 주세요	저쪽 앞에 공영주차장을 이용하세요
콜드브루 라떼에는 설탕이 많이 들어가나요?	무료는 아니예요
콜드브루 라떼는 뭐예요?	여기서 3년 정도 장사했어요
콜드 브루 라떼 한 잔 주시겠어요?	텀블러 할인은 없어요
네, 따뜻하게 주세요	제일 잘나가는 음료를 진열해 둔 거예요
콜드브루가 일반 커피보다 맛이 나은가요?	큰 사이즈 3800원, 작은 사이즈는 3300원이에요
영수증 줄 수 있나요?	네, 프렌차이즈점이에요
차는 어디에 세울 수 있어요?	아메리카노 한 잔 맞으신가요?
공영주차장은 무료인가요?	네, 매장에서 먹고 가도 돼요
여기 하신지 오래되셨나요?	네, 충분히 들어가요
텀블러 할인 있나요?	3500원이요
진열된 상품은 뭐예요?	주차장은 따로 없는데 앞쪽 길가에 세우시면 돼요
프라페는 얼마인가요?	생강청에 우유를 스팀해서 드시는 거예요
프랜차이즈점 인가요?	저희가 생강청을 직접 담궈서 메뉴로 만들어 보았어요
아메리카노 한 잔 주시겠어요?	카드나 현금 둘 다 상관없어요
네, 아메리카노 한 잔만 주세요	3500원이세요
매장에서 먹고 가도 되나요?	2500원이요
이 텀블러에 음료가 다 들어가나요?	아니요, 진저라떼에는 생강청만 들어가요
얼마인가요?	500mL에 23000원이에요
차는 어디에 세울 수 있어요?	영수증 뽑아 드릴게요
진저라떼는 뭔가요?	콜드브루 없어요
겨울이어서 생강 종류가 많은 건가요?	쿠키는 2200원이에요
카드보다는 현금이 더 나은가요?	2500원이요
얼마인가요?	오전 10시에 오픈해요
테이크 아웃으로 하면 얼마인가요?	영수증 뽑아 드릴게요
진저라떼에 꿀이나 설탕 들어가나요?	주차장은 따로 없어요
생강청은 얼마인가요?	저 쪽에 따뜻한 물 있어요
영수증 좀 받을 수 있을가요?	텀블러 할인은 없어요
콜드브루 있나요?	콜드브루가 디카페인이에요
쿠키는 얼마예요?	디카페인은 카페인이 절반 정도 들어간 거예요
아메리카노 따뜻한 거 한 잔 주시겠어요?	진하기는 디카페인이랑 커피 둘 다 비슷해요
오픈 시간이 언젠가요?	아메리카노 투샷 들어가요
영수증 좀 주실래요?	주차할 수 있는 공간이 따로 없어요
차는 어디에 세울 수 있어요?	따뜻한 걸로 드릴까요?
따뜻한 물 한 잔 주시겠어요?	아니요, 텀블러 할인은 없어요
텀블러 할인 있나요?	저희는 다 수제로 만들어요
콜드브루랑 아메리카노랑 뭐가 달라요?	네, 생딸기에요
디카페인은 카페인이 없는 거예요?	네, 주문하시면 저렇게 만들어 드려요
디카페인보다 보통 커피가 더 진한가요?	로스터리 커피는 직접 커피콩을 볶은 거예요
아메리카노에 샷이 몇 개 들어가나요?	사람마다 좋아하시는 커피 종류가 있어서 자기 입맛에 맞는거 찾아서 드시면 괜찮아요
차는 어디에 세울 수 있어요?	따뜻하게 드시나요?
아메리카노 하나 주시겠어요?	텀블러 할인해서 3500원이예요
네, 따뜻한 걸로	네, 텀블러 할인되세요
텀블러 할인 있나요?	아니요, 기본 투샷 들어가요
디저트는 어떻게 만드나요?	네, 영수증 여기 있습니다
타르트에 있는 딸기는 생딸기 인가요?	네, 편한 데 앉으세요
저쪽에 있는 텀블러는 주문 제작하는 건가요?	네, 일반 매장에 커피를 팔기도 해요
로스터리 커피는 뭔가요?	텀블러 할인은 300원이예요
로스터리 커피는 맛이 좋은가요?	아니요, 파는 거 아니예요
아메리카노 한 잔 텀블러에 담아주세요	주차장은 따로 없고 앞쪽이나 뒤쪽 골목에 세워야 해요
네, 따뜻하게 주세요	네 아보카도랑 우유, 시럽이랑 연유도 조금씩 들어가요
아메리카노 한 잔 얼마예요?	네, 완전 아보카도는 4000원이에요
텀블러 할인되나요?	아니요, 테이크 아웃해도 가격은 똑같아요
샷은 원샷이 들아가나요?	주차할 공간이 많지 않아서 시장 안쪽에 세우셔야 해요
영수증 하나 주실래요?	네, 신제품이에요
아무 데나 앉아도 되죠?	네, 19가지가 들어가요
납품도 하나요?	허브 차나 국화차가 많이 나가요
텀블러 할인은 얼마예요?	예 유자차처럼 그런 거에요
커피잔도 다 파시는 거예요?	달게도 가능하고 덜 달게도 가능해요
차는 어디에 세워요?	드시고 가시나요?
아보카도는 그 것만 갈아서 주시는 거예요?	따뜻한 녹차라떼 맞으세요?
아보카도 하나 주세요	3300원이에요
테이크 아웃하면 가격이 더 저렴한가요?	네, 영수증 잔돈이랑 같이 드릴게요
차는 어디에 세워요?	네, 영수증 드릴게요
십구곡라떼가 신제품인가요?	그런건 없어요 가져오는 사람이 없어요
십구곡라떼에 정말 19가지 곡물이 들어가요?	네, 건강에도 좋고 달지도 않아요
커피 말고 차 종류는 뭐가 있나요?	네, 수제차는 직접 만들어요
생강차는 설탕이 많이 들어가나요?	5000원이에요
녹차라떼는 많이 달아요?	네, 영수증 드릴게요
녹차라떼 덜 달게 하나 주시겠어요?	과일을 와인에 절여서 탄산수랑 함께 만드는 음료에요
네, 먹고 갈 거예요	주스에는 오렌지랑 자몽이 들어가요
네, 따뜻한 걸로 주세요	부드러운 거 좋아하시면 블루마운틴 커피, 약간 산미 나는 거 좋아하시면 케냐 커피 많이 드세요
영수증 하나 주실래요?	하우스 블렌딩은 진하고 무거운 맛이에요
영수증 하나 주실래요?	가지고 가시면 2000원이에요
텀블러 할인 있나요?	드시고 가시면 3000원이에요
반반주스 맛있어요?	현금 영수증 맞으세요?
수제차는 직접 만드신 거예요?	네, 여기 드릴게요
반반주스 하나 주시겠어요?	주차장은 따로 없고 타워 맞은편 주차 라인이나 상가 앞에 세우셔야 해요
영수증 하나 주실래요?	
와인에이드가 뭐예요?	
주스에 망고하고 뭐가 들어가요?	
어떤 커피가 잘나가요?	
하우스 블렌딩은 뭐예요?	
약간 산미 나는 걸로 한 잔 주실래요?	
마시고 가면 얼마예요?	
영수증 하나 주실래요?	
아니요, 그냥 영수증이요	
차는 어디에 세울 수 있어요?	
